#AZIRA	AE Z AH R AH
#EFHUN	EH F AH N
#EJMSA	EH JH M Z AH
#EKSON	EH K S AH N
#IHAD	IH HH AH D
#OKEJI	AA K AH JH IY
#ON	AO N
#ONA	AA N AH
#OR#	AO R
#OR#A	AO R AH
<A>	AH
<ESBRITANS>	EH Z R AH T AH N Z
<GRESKA>	G R EH S AH
<INFARK>	IH N F AA R K
<K>	K EY
<KAO>	K EY OW
<MALIJA>	M AH L IH JH AH
<NEP>	N EH P
<OD>	AA D
<ODRE}ENE>	AA D AH R IH N
<OSOBAM>	AA S AH B AH M
<PAPIR>	P AE P AH R
<PIP>	P IH P
<PITANJ>	P IH T AH N JH
<PRIJATILJE>	P R IH JH AH T AH L JH
<RAZMI>	R AE Z M IY
<SIL>	S IH L
<SJEVEROZA>	S JH AH V EH R AH Z AH
<T>	T IY
<TRA>	T R AA
<UDARAC>	Y UW D AH R AH K
<UPOTRIJEBITI>	Y UW P AA T R AH JH EH B AH T IY
<UZDAH>	AH Z D AH
<VRB>	V IY AA R B IY
<ZAKINUTI>	Z AE K AH N Y UW T IY
<{IR>	IH R
<{KRIPANJE>	K R IH P AH N JH
<{UM>	AH M
<~EVTEROGODI{NJE>	
A	AH
A(2)	EY
ABAS	AE B AH Z
ABASA	AE B AH S AH
ADEESEL	EY D IY S AH L
ADENOKARCENOMU	AH D EH N AH K AH R S EH N AH M UW
ADIO	EY D IY OW
ADMINISTRACIJA	AE D M AH N AH S T R AE S AH JH AH
ADRESE	AE D R IY Z
ADRIJA	AE D R AH JH AH
AEMVEBE	EH M V IY B
AEMVEBEA	EH M V IY B IY AH
AFERA	AE F AH R AH
AFGANISTANA	AE F G AH N IH S T AH N AH
AFGANISTANU	AE F G AH N IH S T AH N UW
AFRICI	AE F R AH S IY
AFRIKA	AE F R AH K AH
AFRIKE	AE F R AY K
AFRI~KIH	AE F R IY
AGENCIJA	AH JH EH N S AH JH AH
AGENCIJAMA	AE JH AH N S IH JH AH M AH
AGENCIJE	AE JH AH N S AY JH
AGRESIJE	AE G R AH S AY JH
AGRESIJU	AE G R EH S AH JH UW
AGRESOR	AE G R AH Z AH R
AHARNOT	AH HH AA R N AH T
AHMEDA	AE M AH D AH
AITA	EY T AH
AJAN	EY JH AH N
AJKENU	AE JH K AH N UW
AKADEMIJI	AE K AH D EH M AH JH IY
AKADEMIKA	AE K AH D EH M AH K AH
AKCIJA	AE K S AH JH AH
AKCIJE	AE K S AY JH
AKCIJI	AE K S AH JH IY
AKCIJU	AE K S AH JH UW
AKO	AE K OW
AKTIVIRALA	AE K T AH V IH R AH L AH
AKTIVNIH	AE K T IH V N IY
AKTIVNO	AE K T IH V N OW
AKTUALNA	AE K T Y UW AE L N AH
AKTUALNO	AE K T Y UW AE L N OW
AL	AE L
ALBANACA	AE L B AE N AH K AH
ALBANSKI	AE L B AE N S IY
ALEN	EY L AH N
ALFRED	AE L F R IH D
ALI	AA L IY
ALIJA	AH L AY JH AH
ALKAIDE	AE L K EY D
ALKOHOLA	AE L K AA HH AH L AH
ALTERNATIVE	AO L T ER N AH T IH V
AL`IRAC	AE L IH R AH K
AMBULANTI	AE M B Y AH L AE N T IY
AMERIKA	AH M EH R IH K AH
AMERIKANACA	AE M AH R AH K AE N AH K AH
AMERIKANCA	AE M AH R AH K AE NG K AH
AMERIKANCIMA	AE M AH R AH K AE N S AH M AH
AMERIKE	AE M AH R AY K
AMERI~KA	AE M AH R IY
AMERI~KE	AE M AH R IY
AMERI~KI	AE M AH R IY
AMERI~KIH	AE M AH R IY
AMERI~KIM	AE M AH R IY
AMERI~KOG	AE M AH R IY
AMERI~KOGA	AE M AH R IY
AMERI~KOJ	AE M AH R IY
AN#ELESU	AE N EH L AH S UW
ANA	AA N AH
ANA(2)	AE N AH
ANADOLIJA	AE N AH D AA L AH JH AH
ANALITI~ARA	AH N AE L AH T IY
ANALIZA	AH N AE L AH Z AH
ANDAMANIMA	AE N D AH M AE N AH M AH
ANDAMANU	AE N D AE M AH N UW
ANDRIJA	AE N D R AH JH AH
ANGA`IRALE	AE N G AH IH R EY L
ANIBAL	AE N IH B AH L
ANKICI	AE NG K AH S IY
ANS	AE N Z
ANSAMBLA	AE N S AE M B L AH
ANSARALISLAM	AE N Z ER AH L IY Z L AE M
ANTE	AE N T IY
ANTICIKLONA	AE N T AH S IH K L AH N AH
ANTICIKLONALNI	AE N T AH S IH K L AH N AE L N IY
ANTICIKLONALNO	AE N T AH S IH K L AH N AE L N OW
ANTOFAGASTOM	AE N T AH F AH G AE S T AH M
ANTUN	AE N T AH N
ARABIJI	AH R AE B AH JH IY
ARAFAT	AA R AH F AA T
ARAFATA	AH R AE F AH T AH
ARAFATOM	AH R AE F AH T AH M
ARAPSKO	AH R AE P S OW
ARAPSKOGA	AH R AE P S AH G AH
ARBITRIRATI	AA R B AH T R IH R AH T IY
ARENASOM	AH R EH N AH S AH M
ARENASU	AH R EH N AH S UW
ARGENTINSKA	AA R JH AH N T IH N S AH
ARHIPELAGU	AA R AH P AH L AE G Y UW
ARIEL	EH R IY AH L
ARIELA	AH R IY L AH
ARIJEL	AE R AH JH AH L
ARMIJA	AA R M AH JH AH
AROGANTNIMA	AE R AH G AE N T N AH M AH
ART	AA R T
ASMATI~ARI	AE Z M AH T IY
ASPIRACIJE	AE S IH R AH S AY JH
ASTMATI~ARE	AE S T M AH T IY
ASTMATI~ARI	AE S T M AH T IY
ASTMATI~ARIMA	AE S T M AH T IY
ASTRONAUTI	AE S T R AA N AH T IY
ASTRONAUTIMA	AE S T R AH N AO T AH M AH
ATMOSFERSKOG	AE T M AH S AH R S AH G
AUDIJENCIJE	AH D IH JH AH N S AY JH
AUDIOSPOTOVI	AO D IY AH S AA T AH V IY
AUGUSTA	AH G AH S T AH
AUSTRALCI	AO S T R AE L S IY
AUSTRALIJE	AO S T R AH L AY JH
AUSTRIJSKI	AO S T R IH JH S K IY
AUSTRIJSKOGA	AO S T R IH JH S K AH G AH
AUTENTI~NIM	AH T EH N T IY
AUTO	AO T OW
AUTOBUS	AO T OW B AH S
AUTOBUSI	AO T AH B Y UW S IY
AUTOCESTA	AO T AH S EH S T AH
AUTOCESTAMA	AO T AH S EH S T AH M AH
AUTOCESTE	AO T AH S AH S T
AUTOCESTI	AO T AH S EH S T IY
AUTOCESTOM	AO T AH S EH S T AH M
AUTOCESTU	AO T AH S EH S T UW
AUTOKLUB	AH T AA K L AH B
AUTOKLUBOVIMA	AH T AA K L AH B AA V AH M AH
AUTOMEHANI~AR	AO T AH M EH HH AH N IY
AUTOMOBILA	AO T AH M AA B AH L AH
AUTOMOBILI	AO T OW M OW B IY L IY
AUTOMOBILIMA	AO T AH M AH B IH L AH M AH
AUTOMOBILISTI~KE	AH T AA M AH B AH L IH S T IY
AUTOMOBILOM	AO T AH M AA B AH L AH M
AUTOMOBILU	AO T AH M AA B AH L UW
AUTORA	AO T AH R AH
AUTORI	AO T AH R IY
AUTORICA	AH T AO R AH K AH
AUTORITARNOME	AH T AH R IH T AH R N OW M
AVANGARD	AH V AE N G AH R D
AVENIJE	AE V AH N AY JH
AVIJATI~AR	AH V IH JH AH T IY
AVIJATI~ARU	AH V IH JH AH T IY
AZIJE	AH Z AY JH
AZIJI	AE Z AH JH IY
AZIJOM	AE Z AH JH AH M
AZIJSKIH	AH Z IH JH S K IY
AZIJU	AE Z AH JH UW
A~EHU	AH
BABINU	B AE B AH N UW
BABI^	B AE B IY
BADAGSAN	B EY D IH JH Z AH N
BADAGSANU	B AH D AE G S AH N UW
BAGDADA	B AE G D AA D AA
BAJ#IJU	B AE JH IH JH UW
BAJRAM	B AE JH R AH M
BAJRAMA	B AE JH R AH M AH
BAKI	B AE K IY
BALKANSKIM	B AO L K AH N S K IH M
BALTAZAR	B AA L T AA Z AA R
BANJALU~KI	B AE N JH AH L UW
BANKA	B AE NG K AH
BANKE	B AE NG K
BANKOKU	B AE NG K AH K UW
BARANJSKE	B AE R AH N JH S K
BARBARSTVOM	B AA R B AA R S T V AH M
BARI^	B AE R IY
BAROVE	B AH R OW V
BATISTE	B AH T IH S T AH
BAZE	B EY Z
BAZU	B AE Z UW
BA{	B AA
BEBI^	B AH B IY
BEIHA	B AH IH HH AH
BEJBI	B IH JH IY
BELFASTA	B IH L F AE S T AH
BELFASTU	B IH L F AE S T UW
BEN	B EH N
BENATSA	B AH N AE T S AH
BENVENTU	B IH N V EH N T UW
BENZINA	B IH N Z IH N AH
BEOGRADA	B AH AA G R AH D AH
BEOGRADSKI	B AH AA G R AE D S K IY
BEOGRADU	B AH AA G R AH D UW
BERISLAV	B AH R IH Z L AH V
BERISLAVA	B IY AH R IY Z L AA V AH
BERLINU	B IH R L IH N UW
BERLUSKONI	B IH R L AH S AH N IY
BESPLATNA	B IH S L AE T N AH
BETLEHEMU	B IH T L EH HH AH M UW
BETONA	B AH T OW N AH
BETONSKI	B IH T AH N S K IY
BEZ	B EH Z
BE~A	B IY
BE~KI	B IY
BE~U	B IY
BI	B AY
BIBISIJA	B AY B AH S IH JH AH
BIG	B IH G
BIH	B IY
BIJENALU	B AY JH EH N AH L UW
BILA	B IY L AH
BILE	B AY L
BILI	B AY L IY
BILJARA	B AY L JH AE R AH
BILO	B AY L OW
BILOGORSKA	B AY L AH G AO R S AH
BILTENU	B AY L T EH N UW
BIO	B AY OW
BIOKOVU	B AY AA K AH V UW
BIOMETEOROLO{KA	B AY AH M IY T IY AO R AH L OW K AA
BIOMETEOROLO{KE	B AY AH M IY T IY AO R AH L OW K IY
BIOMETEOROLO{KI	B AY AH M IY T IY AO R AH L OW K IY
BIOMETEOROLO{KIH	B AY AH M IY T IY AO R AH L OW K IY
BIRA	B AY R AA
BIRATI	B AY R AE T IY
BIRA~A	B AY R AA
BIRA~I	B AY R AA
BIRA~KA	B AY R AA
BIRA~KIH	B AY R AA
BIRA~KIM	B AY R AA
BISKUP	B IH S K AH P
BISKUPSKE	B AY S AH P S
BISTRINE	B AY S T R AY N
BIT	B IH T
BITI	B AY T IY
BITKU	B AY T UW
BIV{A	B IH V AH
BIV{E	B IH V
BIV{EG	B IH V EH G
BIV{I	B IH V AY
BIV{IH	B IH V IY
BIV{IM	B IH V IH M
BJELOVARSKO	B JH EH L AH V AA R S OW
BJELOVARSKOG	B JH EH L AH V AA R S AH G
BJELOVARU	B JH AH L AA V AH R UW
BLAGAJU	B L AE G AH JH UW
BLAGDAN	B L AE G D AH N
BLAGDANA	B L AE G D AH N AH
BLAGDANE	B L AE G D EY N
BLAGDANI	B L AE G D AH N IY
BLAGDANSKOG	B L AE G D AE N S AH G
BLA{KI^	B L AA K IY
BLA{KI^A	B L AA K IY AH
BLA{KI^EVA	B L AA K IY EH V AH
BLA{KI^EVU	B L AA K IY EH V UW
BLER	B L EH R
BLERA	B L EH R AH
BLEROVOJ	B L EH R AH V AH JH
BLISKE	B L IH S
BLISKOG	B L IH S AH G
BLISKOISTO~NE	B L IH S OY S T OW
BLIZINI	B L IH Z AH N IY
BLIZU	B L IH Z UW
BLJESAK	B L JH EH S AH K
BLOKA	B L AA K AH
BLOKADU	B L AA K AH D UW
BODEVINSKOM	B AA D AH V IH N S AH M
BOGATA	B AA G AH T AH
BOINGA	B OY N G AH
BOJKOTIRAJU	B AA JH K AH T IH R AH JH UW
BOJNE	B AA JH N
BOKELJSKA	B AH K EH L JH S K AH
BOLCANU	B OW L K AH N UW
BOLESNICI	B AH L EH Z N AH S IY
BOLESNICIMA	B AA L AH Z N IH S AH M AH
BOLESNIKA	B AH L EH Z N AH K AH
BOLESNIKE	B AA L AH Z N AY K
BOLEST	B OW L AH S T
BOLESTAN	B OW L EH S T AH N
BOLESTI	B AH L EH S T IY
BOLESTIMA	B AH L EH S T AH M AH
BOLJE	B OW L JH
BOLNICA	B OW L N AH K AH
BOLNICAMA	B OW L N IH K AH M AH
BOLNICI	B OW L N AH S IY
BOLNICU	B OW L N AH K UW
BOLNI~KO	B OW L N IY
BOLONJI	B AH L AA N JH IY
BOLONT	B AA L AH N T
BOLOVA	B AA L AH V AH
BOLOVE	B AH L OW V
BOLSANU	B OW L S AH N UW
BOL}ANA	B AA L AE N AH
BOL}ANU	B AA L AE N UW
BOMBA	B AA M B AH
BOMBAMA	B AA M B AH M AH
BOMBARDIRAN	B AA M B AA R D AH R AH N
BOMBA{A	B AA M B AH AH
BOMBI	B AA M B IY
BONA~I	B OW N AH
BONUS	B OW N AH S
BORAVE	B AH R EY V
BORAVI	B AO R AH V IY
BORAVKA	B AH R AE V K AH
BORBAMA	B AO R B AH M AH
BORBE	B IY ER B IY
BORBI	B AO R B IY
BORBU	B AO R B UW
BORE	B AO R
BORIS	B AO R IH S
BORISA	B AO R AH S AH
BOROVE	B AH R OW V
BOSILJEVA	B AH S IH L JH AH V AH
BOSNE	B AA Z N
BOSNI	B AA Z N IY
BOTOVO	B AA T AH V OW
BO`I^	B OW AY
BO`I^NE	B OW AY N IY
BO`I^NI	B OW AY N IY
BO`I^NO	B OW AY N OW
BO`I^NOM	B OW AY N AA M
BO`JA	B OW JH AA
BO`JU	B OW JH UW
BO{NJAKA	B OW N JH AE K AH
BO{NJA~KOHRVATSKOGA	B OW N JH AA
BRAJANA	B R AE JH AH N AH
BRAKU	B R AE K UW
BRANDEBUR{KA	B R AE N D AH B AH R K AA
BRANILA	B R AE N AH L AH
BRANITELJA	B R AE N AH T EH L JH AH
BRANKA	B R AE NG K AH
BRA^E	B R AA
BRA^OM	B R AA AA M
BRA~A	B R AA
BRA~NI	B R AA
BRA~NOG	B R AA
BRA~U	B R AA
BRDU	B R D UW
BRE{KOVI^	B AH R K OW V IY
BRIGADNI	B R AH G AE D N IY
BRIGU	B R IH G Y UW
BRINJSKA	B R IH N JH S K AH
BRINJU	B R IH N JH UW
BRISELA	B R IH S AH L AH
BRISELOM	B R IH S AH L AH M
BRISELU	B R IH S AH L UW
BRITANIJA	B R AH T AE N AH JH AH
BRITANIJE	B R IH T AH N AY JH
BRITANSKA	B R AH T AE N S AH
BRITANSKE	B R IH T AH N S
BRITANSKI	B R AH T AE N S IY
BRITANSKIH	B R AH T AE N S IY
BRITANSKIM	B R AH T AE N S AH M
BRITANSKOGA	B R AH T AE N S AH G AH
BRITANSKOM	B R AH T AE N S AH M
BROD	B R AA D
BRODOGRADILI{TA	B R AA D AH G R AE D AH L IY T AA
BROJ	B R AA JH
BROJEVIMA	B R AH JH EH V AH M AH
BROJKA	B R AA JH K AH
BROJU	B R AA JH UW
BRON~ANE	B R AA N
BRO{URA	B R OW Y UH R AH
BRUS	B R AH S
BRZINE	B R Z AY N
BRZO	B R Z OW
BRZOJ	B R Z AA JH
BRZOJAV	B R Z AA JH AH V
BRZOJAVU	B R Z AA JH AH V UW
BR`E	B R
BUDE	B Y UW D
BUDIMPE{TA	B Y UW D AH M P T AA
BUDU^I	B Y UW D UW AY
BUDU^IM	B Y UW D UW IH M
BUDU^NOST	B Y UW D UW N AA S T
BUDU^NOSTI	B Y UW D UW N AA S T IY
BUDU^U	B Y UW D UW UW
BUKI	B Y UW K IY
BUKNUO	B AH K N Y UW OW
BULI~I^	B Y UW L IY
BULI~I^EM	B Y UW L IY
BUR#ELEZ	B AH R EH L AH Z
BURA	B Y UH R AH
BURE	B IY Y ER
BURIN	B Y UH R AH N
BUROM	B Y UH R AH M
BURU	B Y UH R UW
BU{	B UW
BU{A	B UW AH
BU~NIMA	B UW
CAVTATU	K AE V T AH T UW
CENTAR	S EH N T ER
CENTRA	S EH N T R AH
CESTA	S EH S T AH
CESTARINA	S EH S T AE R AH N AH
CESTARINE	S EH S T AH R AY N
CESTE	S EH S T
CESTI	S EH S T IY
CESTOVNE	S EH S T AH V N
CESTOVNOG	S EH S T AA V N AH G
CESTOVNOM	S EH S T AA V N AH M
CIGARETE	S IH G AH R IY T
CIJELA	S IH JH AH L AH
CIJELE	S AH JH IY L
CIJELIH	S IH JH AH L IY
CIJELOGA	S AH JH EH L AH G AH
CIJELOJ	S IH JH AH L AH JH
CIJELOM	S IH JH AH L AH M
CIJELU	S IH JH AH L UW
CIJENA	S IH JH AH N AH
CIJENE	S AH JH IY N
CIJENI	S IH JH AH N IY
CIJENU	S IH JH AH N UW
CIKLONA	S IH K L AH N AH
CIKLONALNO	S IH K L AH N AE L N OW
CIKLONE	S IH K L OW N
CILJEM	S IH L JH AH M
CILJEVE	S IH L JH IY V
CILJU	S IH L JH UW
CIPAR	S AY P AH R
CIVILA	S IH V AH L AH
CIVILNE	S IH V AH L N
CIVILNIH	S AH V IH L N IY
CJELOSTI	K JH AH L AA S T IY
CJELOVITE	K JH EH L AH V AY T
CJELOVITOST	K JH AH L AA V AH T AH S T
COTA	K OW T AH
CRKAVA	K R K AE V AH
CRNA	K R N AA
CRNAC	K R N AE K
CRNE	K R N
CRNIM	K R N IH M
CRNI^	K R N IY
CRNOBORI	K R N AA B AH R IY
CRNOGA	K R N AA G AH
CRNOJ	K R N AA JH
CRNU	K R N UW
CRTICA	K R T IH K AH
CRVENI	K R V EH N IY
CRVENOG	K R V EH N AH G
CRVENOGA	K R V EH N AH G AH
CUNAMI	K Y UW N AH M IY
CUNAMIJA	K Y UW N AE M AH JH AH
CUNAMIJEM	K Y UW N AE M AH JH AH M
CUNAMIJI	K Y UW N AE M AH JH IY
CUNAMIJIMA	K Y UW N AH M IH JH AH M AH
CUNAMIJU	K Y UW N AE M AH JH UW
CVJETANOVI^	K V JH AH T AE N AH V IY
DA	D AA
DA(2)	D IY EY
DAJU	D AE JH UW
DALA	D AE L AH
DALI	D AA L IY
DALJE	D AE L JH
DALJNJE	D AE L JH N JH
DALJNJEGA	D AE L JH N JH AH G AH
DALMACIJE	D AE L M AH S AY JH
DALMACIJI	D AE L M AE S AH JH IY
DALMATINSKE	D AE L M AH T AH N S
DALMATINSKOJ	D AE L M AH T IH N S AH JH
DALO	D AA L OW
DAMIR	D AE M AH R
DAMIRA	D AE M AH R AH
DAMIROM	D AE M AH R AH M
DAN	D AE N
DANA	D EY N AH
DANAS	D AE N AH Z
DANA{NJE	D AE N AH N JH IY
DANA{NJEG	D AE N AH N JH EH G
DANA{NJI	D AE N AH N JH IY
DANA{NJOJ	D AE N AH N JH AA JH
DANE	D EY N
DANJU	D AE N JH UW
DANO	D AA N OW
DANOM	D AE N AH M
DAO	D AW
DARFURSKIH	D AA R F AH R S IY
DARFURU	D AA R F Y AH R UW
DARIJA	D AE R AH JH AH
DARIVANJE	D AE R AH V AH N JH
DAROVALI	D AH R AA V AH L IY
DAROVE	D AH R OW V
DATI	D AE T IY
DATUM	D AE T AH M
DATUM(2)	D EY T AH M
DATUMA	D AE T Y UW M AH
DAVOR	D EY V AH R
DA~I	D AA
DECEA	D AH S IY
DECEU	D AH S UW
DEESA	D IY EH S AH
DEESE	D IY Z
DEESESA	D IY EH S AH S AH
DEESU	D IY EH S UW
DEFICITA	D AH F IH S AH T AH
DEJANOVI^	D AH JH AE N AH V IY
DEL	D EH L
DELA	D EH L AH
DELASERA	D AH L AE S AH R AH
DELNICA	D IH L N IH K AH
DELNICE	D EH L N AH S
DELO	D EH L OW
DEMOKRACIJE	D AH M AA K R AH S AY JH
DEMOKRACIJU	D AH M AA K R AE S AH JH UW
DEMOKRATIZACIJE	D AH M AH K R AH T IH Z AH S AY JH
DEMOKRATSKA	D AH M AA K R AE T S AH
DEMOKRATSKE	D AH M AA K R AH T S
DEMOKRATSKOG	D AH M AA K R AE T S AH G
DEMOKRATSKOGA	D AH M AA K R AE T S AH G AH
DENIS	D EH N IH S
DEPOZITI	D AH P AA Z AH T IY
DEPRESIJSKO	D IH P R AH S IH JH S K OW
DER	D ER
DESET	D IY S EH T
DESETA	D AH S EH T AH
DESETAK	D AH S EH T AH K
DESETERO	D AH S EH T AH R OW
DESETOGA	D AH S EH T AH G AH
DESETOJ	D AH S EH T AH JH
DETALJNIM	D AH T AE L JH N AH M
DEVEDESET	D AH V EH D AH S AH T
DEVEDESETIH	D AH V AH D EH S AH T IY
DEVET	D IY V EH T
DEVETE	D AH V IY T
DEVETERO	D AH V EH T AH R OW
DEVETNAEST	D AH V EH T N EY AH S T
DEVETNAESTI	D AH V EH T N IY S T IY
DEVETNAESTOGA	D AH V EH T N IY S T AH G AH
DEVETOGA	D AH V EH T AH G AH
DEVETORICA	D AH V AH T AO R AH K AH
DEVETORICE	D IY V IY T OW R AY S
DEVETSTO	D AH V EH T S T OW
DEVIZNI	D AH V IH Z N IY
DI	D IY
DI(2)	D AY
DIJAGNOSTI~KI	D IH JH AH G N AA S T IY
DIJAGNOZU	D AH JH AE G N AH Z UW
DIJALOG	D IH JH AH L AH G
DIJALOGU	D IH JH AH L AA G Y UW
DIJASPORU	D AH JH AE S AH R UW
DIJELA	D IH JH AH L AH
DIJELOM	D IH JH AH L AH M
DIJELOVIMA	D IH JH AH L AA V AH M AH
DIJELU	D IH JH AH L UW
DIKTATORA	D IH K T AE T AH R AH
DILJEM	D IH L JH AH M
DIMA	D IH M AH
DIMITRIJE	D IH M AH T R AY JH
DIMOM	D IH M AH M
DIN	D IH N
DIO	D AY OW
DIOKLECIJANOVU	D AY AA K L AH S AH JH AE N AH V UW
DIOKSINOM	D AY AA K S AH N AH M
DIONI~ARA	D AY AH N IY
DIONI~ARI	D AY AH N IY
DIPARTMENT	D IH P AA R T M AH N T
DIPLOMACIJE	D IH P L AA M AH S AY JH
DIPLOMAT	D IH P L AH M AE T
DIPLOMATA	D IH P L AA M AH T AH
DIREKTOR	D AH R EH K T AH R
DIREKTORICA	D IH R AH K T AO R AH K AH
DIREKTOROM	D AH R EH K T AH R AH M
DIREKTORU	D AH R EH K T AH R UW
DISK	D IH S K
DISKOTEKE	D IH S AH T IY K
DI`E	D IY
DJECA	JH EH K AH
DJECE	JH IY S
DJECI	JH EH S IY
DJECU	JH EH K UW
DJEDA	JH EH D AH
DJEDAMRAZIJA	JH EH D AH M R AE Z AH JH AH
DJELA	JH EH L AH
DJELATNICI	JH AH L AE T N AH S IY
DJELATNIK	JH AH L AE T N AH K
DJELATNIKA	JH AH L AE T N AH K AH
DJELATNOST	JH AH L AE T N AH S T
DJELATNOSTIMA	JH EH L AH T N AA S T AH M AH
DJELIMA	JH EH L AH M AH
DJELO	JH EH L OW
DJELOMICE	JH EH L AH M AH S
DJELOMI~NIM	JH EH L AH M IY
DJELOMI~NO	JH EH L AH M IY
DJELOVATI	JH AH L AA V AH T IY
DJELUJE	JH AH L UW JH
DJETETA	JH EH T AH T AH
DJEVOJ~ICA	JH EH V AH JH
DJEVOJ~ICI	JH EH V AH JH
DJEVOJ~ICU	JH EH V AH JH
DJE~AK	JH IY
DJE~JE	JH IY
DJE~JEG	JH IY
DNEVNA	D N EH V N AH
DNEVNE	D N EH V N
DNEVNI	D N EH V N IY
DNEVNOM	D N EH V N AH M
DO	D UW
DOBA	D OW B AH
DOBAR	D UW B AA R
DOBIJE	D AH B AY JH
DOBILA	D AA B AH L AH
DOBILI	D AA B AH L IY
DOBIO	D OW B IY OW
DOBITI	D AA B AH T IY
DOBIVAJU	D AH B IH V AH JH UW
DOBRE	D OW B AH R
DOBRO	D OW B R OW
DOBROM	D AA B R AH M
DOBROME	D AA B R OW M
DOBROTE	D AA B R OW T
DOBROTU	D AA B R AH T UW
DODAJMO	D AH D AE JH M OW
DODAJU^I	D AA D AH JH UW AY
DODAO	D AA D EY OW
DODATI	D AA D AH T IY
DODIJELILA	D AA D AH JH EH L AH L AH
DODIJELJENA	D AA D AH JH EH L JH AH N AH
DODJELI	D AA JH AH L IY
DODJELJENI	D AA JH EH L JH AH N IY
DOGA}AJA	D OW G AH AE JH AH
DOGODILA	D AH G AA D AH L AH
DOGODILI	D AH G AA D AH L IY
DOGODIO	D AH G OW D IY OW
DOGODITI	D AH G AA D AH T IY
DOGOVOR	D AA G AH V AH R
DOGOVORENIH	D AA G AH V AO R AH N IY
DOGOVORENO	D AA G AH V AO R AH N OW
DOGOVORILE	D AH G AA V AH R AH L
DOGOVORIO	D AA G AH V AO R IY OW
DOHI	D AA HH IY
DOJAVE	D AH JH EY V
DOK	D AA K
DOKA	D OW K AH
DOKAZ	D AA K AH Z
DOKAZA	D AA K AH Z AH
DOKAZE	D AH K EY Z
DOKTOR	D AA K T ER
DOKTORA	D AA K T AH R AH
DOKTORU	D AA K T AH R UW
DOKUMENT	D AA K Y UW M AH N T
DOKUMENTACIJE	D AA K Y AH M EH N T AH S AY JH
DOKUMENTOM	D AA K Y AH M EH N T AH M
DOKUMENTU	D AA K Y AH M EH N T UW
DOLAR	D OW L ER
DOLARA	D AA L AH R AH
DOLASKA	D AH L AE S AH
DOLAZAK	D AA L AH Z AH K
DOLINA	D AA L AH N AH
DOLINI	D AA L AH N IY
DOMA	D OW M AH
DOMA^I	D OW M AH AY
DOMA^IN	D OW M AH IH N
DOMINIRAJU	D AA M AH N IH R AH JH UW
DOMI^	D OW M IY
DOMOVA	D AA M AH V AH
DOMOVIMA	D AH M AA V AH M AH
DOMOVINSKE	D AA M AH V AH N S
DOMOVINSKOG	D AA M AH V IH N S AH G
DOMOVINSKOGA	D AA M AH V IH N S AH G AH
DOMOVINSKOM	D AA M AH V IH N S AH M
DOMU	D OW M UW
DONACIJA	D AH N AE S AH JH AH
DONACIJE	D AA N AH S AY JH
DONATORSKOG	D AA N AH T AO R S AH G
DONEDAVNO	D AA N AH D AE V N OW
DONESENA	D AH N EH S AH N AH
DONIJELA	D AH N IH JH AH L AH
DONIJETI	D AH N IH JH AH T IY
DONIRATI	D AH N IH R AH T IY
DONJA	D AA N JH AH
DONJEG	D AA N JH AH G
DONJI	D AA N JH IY
DONOSI	D AA N AH S IY
DONOSIO	D AH N OW S IY OW
DONO{ENJEM	D OW N OW IH N JH EH M
DONO{ENJU	D OW N OW IH N JH UW
DOPIS	D OW P IY Z
DOPISNICA	D AH P IH Z N AH K AH
DOPISNIK	D AH P IH Z N AH K
DOPREDSJEDNIK	D AA P R AH D S JH EH D N AH K
DOPREMI	D AA P R AH M IY
DOPREMIO	D AA P R IY M IY OW
DOPUNSKE	D AA P AH N S
DOPUNSKIM	D UW P AH N S K IH M
DOPUSTILI	D AH P AH S T AH L IY
DOPU{TENA	D OW P UW T EH N AH
DOSAD	D UW S AE D
DOSADA	D AA S AH D AH
DOSADA{NJEG	D AA S AH D AH N JH EH G
DOSADA{NJI	D AA S AH D AH N JH IY
DOSADA{NJIH	D AA S AH D AH N JH IY
DOSLJEDNO	D AA Z L JH EH D N OW
DOSTAVITI	D AA S T AE V AH T IY
DOSTAVLJENA	D AA S T AE V L JH AH N AH
DOVEDENI	D AH V EH D AH N IY
DOZNA	D AA Z N AH
DOZNAJE	D AA Z N EY JH
DOZNAJEMO	D AA Z N AE JH AH M OW
DOZVOLE	D AA Z OW L
DO^I	D UW AY
DO`IVIO	D UW IH V IY OW
DO`IVLJAVA	D UW IH V L JH AH V AH
DO`IVOTNU	D UW AH V AA T N UW
DO{LI	D UW L IY
DO{LO	D UW L OW
DO}U	D UW UW
DO~ARATI	D UW
DO~EK	D UW
DO~EKA	D UW
DO~EKALA	D UW
DO~EKALI	D UW
DO~EKANA	D UW
DO~EKAO	D UW
DO~EKU	D UW
DRAGUTIN	D R AE G Y UW T AH N
DRAMA	D R AA M AH
DRAMI	D R AE M IY
DRAMSKA	D R AE M S AH
DRAVA	D R AE V AH
DRA`EN	D R AA EH N
DRA{KOVI^A	D R AA K OW V IY AH
DRNOV{EK	D R N AA V EH K
DROGA	D R AA G AH
DROGE	D R OW JH
DRUGA	D R UW G AH
DRUGDJE	D R AH G
DRUGE	D R UW JH
DRUGI	D R UW JH IY
DRUGO	D R UW G OW
DRUGOG	D R UW G AH G
DRUGOGA	D R UW G AH G AH
DRUGOJ	D R UW G AH JH
DRUGOM	D R UW G AH M
DRUGOME	D R UW G OW M
DRU`BA	D R UW B AA
DRU`IO	D R UW AY OW
DRU{TVENE	D R UW T V IY N
DRVENIK	D R V EH N AH K
DRVENIKU	D R V EH N AH K UW
DR`AVA	D R AE V AH
DR`AVAMA	D R AE V AH M AH
DR`AVE	D R AA V EY
DR`AVI	D R AE V IY
DR`AVLJANA	D R AE V L JH AH N AH
DR`AVLJANINA	D R AE V L JH AE N AH N AH
DR`AVLJANKA	D R AE V L JH AE NG K AH
DR`AVNA	D R AE V N AH
DR`AVNE	D R AE V N
DR`AVNIH	D R AE V N IY
DR`AVNIM	D R AE V N AH M
DR`AVNO	D R AE V N OW
DR`AVNOG	D R AE V N AH G
DR`AVNOGA	D R AE V N AH G AH
DR`AVNOJ	D R AE V N AH JH
DR`AVNOM	D R AE V N AH M
DR`AVU	D R AE V UW
DR`E	D R
DR`I	D R AY
DR`I^A	D R AY AH
DUBRAVKA	D AH B R AE V K AH
DUBRAVKO	D AH B R AE V K OW
DUBRAVKU	D AH B R AE V K UW
DUBROVA~KA	D AH B R AH V AH
DUBROVA~KE	D AH B R AH V AH
DUBROVA~KIH	D AH B R AH V AH
DUBROVA~KO	D AH B R AH V AH
DUBROVA~KOGA	D AH B R AH V AH
DUBROVA~KOJ	D AH B R AH V AH
DUBROVA~KOM	D AH B R AH V AH
DUBROVA~KOME	D AH B R AH V AH
DUBROVNIK	D UW B R AA V N IH K
DUBROVNIKA	D AH B R AA V N AH K AH
DUBROVNIKU	D AH B R AA V N AH K UW
DUBROV~ANI	D AH B R AH V
DUGA	D Y UW G AH
DUGI	D Y UW JH IY
DUGIM	D Y UW JH AH M
DUGO	D UW G OW
DUGOGODI{NJA	D Y UW G AA G AH D IY N JH AA
DUGOGODI{NJEG	D Y UW G AA G AH D IY N JH EH G
DUGOGODI{NJI	D Y UW G AA G AH D IY N JH IY
DUGORO~NE	D Y UW G AH R OW
DUGORO~NU	D Y UW G AH R OW
DUGOVA	D AH G OW V AH
DUGOVE	D Y UW G OW V
DUHOVNOM	D AH HH AA V N AH M
DULJE	D AH L JH
DULJIH	D AH L JH IY
DUMANI^	D Y UW M AH N IY
DUNAV	D Y UW N AH V
DU`	D UW
DU`A	D UW AH
DU`AN	D UW AE N
DU`E	D UW
DU`IH	D UW IY
DU`IM	D UW IH M
DU`NICI	D UW N IH S IY
DU`NOSNICI	D UW N AA Z N AH S IY
DU`NOSNICIMA	D UW N AA Z N IH S AH M AH
DU`NOSNIK	D UW N AA Z N AH K
DU`NOSNIKA	D UW N AA Z N AH K AH
DU`NOST	D UW N AA S T
DU`NOSTI	D UW N AA S T IY
DU{ANA	D UW AE N AH
DVA	D V AA
DVADESET	D V AE D AH S AH T
DVADESETAK	D V AH D EH S AH T AH K
DVADESETOG	D V AH D EH S AH T AH G
DVAJU	D V AE JH UW
DVANAEST	D V AE N EY AH S T
DVANAESTOGA	D V AH N IY S T AH G AH
DVAPUT	D V AE P AH T
DVIJE	D V AY JH
DVIJETISU^ITE	D V AH JH EH T AH S UW AY T
DVIJU	D V IH JH UW
DVJESTO	D V JH EH S T OW
DVJESTOTINJAK	D V JH EH S T AH T IH N JH AH K
DVODOMNOG	D V AH D AA M N AH G
DVOJA	D V AA JH AH
DVOJE	D V OW JH
DVOJICA	D V AA JH AH K AH
DVOR	D V AO R
EDUKATIVNIH	EH D Y UW K AH T IH V N IY
EDUKATIVNU	EH D Y UW K AH T IH V N UW
EFBIAJA	EH F B IY AH JH AH
EFENDI	AH F EH N D IY
EGEJSKOME	EH JH AH JH S K OW M
EGIPAT	EH JH AH P AH T
EKIPA	EH K AH P AH
EKIPAMA	AH K IH P AH M AH
EKIPE	AH K AY P
EKOLO{KE	EH K AH L OW K IY
EKOLO{KIM	EH K AH L OW K IH M
EKOLO{KU	EH K AH L OW K UW
EKSPLOZIJA	EH K S L AA Z AH JH AH
EKSPLOZIJI	EH K S L AA Z AH JH IY
EKSPLOZIJU	EH K S L AA Z AH JH UW
EKSPLOZIVA	EH K S L AA Z AH V AH
EKSPLOZIVNA	EH K S L AH Z IH V N AH
ELEKTRONI~KI	AH L EH K T R AH N IY
ELITE	IH L IY T
ELITE(2)	EY L IY T
ELIZEJSKE	EH L AH Z AH JH S K
EMISIJE	IH M AH S AY JH
EMISIJU	AH M IH S AH JH UW
EMPET	IH M P EH T
ENDOSKOPSKE	IH N D AA S AH P S
ENGLAJTNER	IH N G L AE JH T N AH R
ENKLAVE	IH N K L EY V
EPICENTRA	EH P AH S EH N T R AH
EPICENTROM	EH P AH S EH N T R AH M
EPICENTRU	EH P AH S EH N T R UW
EPIDEMIJE	AH P IH D AH M AY JH
ER	ER
ERAK	EH R AH K
ERBAS	AH R B AH Z
ERBASA	AH R B AH S AH
ERBILU	AH R B AH L UW
ERDOGAN	AH R D AH G AH N
ERO	IH R OW
ERTEELU	AH R T IY L UW
ESBEUA	EH Z Y UW AH
ESEMES	AH S IY M Z
ESKOBAR	EH S AH B AH R
ESTONIJI	EH S T AA N AH JH IY
ETI~KI	EH T IY
ETNA	EH T N AH
EURA	Y UW R AH
EUROATLANSKIM	Y UW R OW T L AE N S AH M
EUROATLANTSKE	Y UW R OW T L AH N T S
EUROPE	Y UH R AH P
EUROPI	Y UW R AH P IY
EUROPSKA	Y UW R AA P S AH
EUROPSKE	Y UW R AH P S
EUROPSKI	Y UW R AA P S IY
EUROPSKIH	Y UW R AA P S IY
EUROPSKOG	Y UW R AA P S AH G
EUROPSKOJ	Y UW R AA P S AH JH
EUROPSKOM	Y UW R AA P S AH M
EUROPSKU	Y UW R AA P S UW
EUROPU	Y UW R AH P UW
EVAKUACIJOM	AH V AE K Y UW AE S AH JH AH M
EVAKUACIJU	AH V AE K Y UW AE S AH JH UW
EVAKUIRANO	EH V AH K UW R AH N OW
EVIDENTIRATI	EH V AH D AH N T IH R AH T IY
FABIJA	F AE B AH JH AH
FABIJANOVI^	F AE B AH JH AE N AH V IY
FARMACEUTSKE	F AA R M AH S UW T S
FENOMEN	F EH N OW M AH N
FERAL	F EH R AH L
FERENC	F ER EH N S
FERNANDEZ	F ER N AE N D EH Z
FERNANDEZ(2)	F EH R N AE N D EH Z
FERNANDEZ(3)	F ER N AA N D EH Z
FERNANDEZ(4)	F EH R N AA N D EH Z
FESTIVALOM	F EH S T IH V AH L AH M
FEZABADU	F AH Z AE B AH D UW
FIATOM	F AY AH T AH M
FIKSNE	F IH K S N
FILHARMONI~ARI	F IH L HH AA R M AH N IY
FILM	F IH L M
FILMA	F IH L M AH
FILMSKI	F IH L M S K IY
FILMU	F IH L M UW
FINANCIJA	F AH N AE N S AH JH AH
FINANCIJSKI	F IH N AH N S IH JH S K IY
FINANCIJSKIH	F IH N AH N S IH JH S K IY
FINANCIRA	F AH N AE N S AH R AH
FINSKA	F IH N S AH
FINSKIM	F IH N S K IH M
FI{ER	F IY EH R
FLORIN~I^	F L AO R AH N
FLOTAU	F L AA T AH
FLOTI	F L AA T IY
FOLKLORNOG	F OW L K L AO R N AH G
FORMALNO	F AO R M AE L N OW
FORMIRA	F AO R M AH R AH
FORMIRANJE	F AO R M AH R AH N JH
FORTUNI	F AO R T Y AH N IY
FORUM	F AO R AH M
FRANC	F R AE NG K
FRANCUSKE	F R AE NG K AH S
FRANCUSKI	F R AE NG K AH S IY
FRANCUSKOJ	F R AE NG K AH S AH JH
FRANCUZ	F R AE NG K AH Z
FRANJE	F R AE N JH
FRANJO	F R AE N JH OW
FRANS	F R AE N Z
FRANSPRES	F R AE N S AH R Z
FRANSPRESA	F R AE N S R AH S AH
FRONTA	F R AA N T AH
FRONTALNI	F R AA N T AE L N IY
FRONTALNIM	F R AA N T AE L N AH M
FRONTE	F R AA N T
FRONTOM	F R AA N T AH M
GA	G AA
GA(2)	JH IY EY
GA(3)	JH AO R JH AH
GALERIJA	G AH L EH R AH JH AH
GALOVI^	G AE L AH V IY
GARA`E	G AE R AH
GARDE	G AA R D
GARSON	G AA R S AH N
GASITELJI	G AE S AH T EH L JH IY
GAZE	G EY Z
GDJE	G JH
GECAN	JH IY K AH N
GENERACIJAMA	JH EH N AH R AH S IH JH AH M AH
GENERAL	JH EH N ER AH L
GENERAL(2)	JH EH N R AH L
GENERALA	JH AH N EH R AH L AH
GENERALNOG	JH EH N AH R AE L N AH G
GENOCID	JH EH N AH S AH D
GENOCIDA	JH AH N AA S AH D AH
GEOFIZI~KOG	JH IY AA F AH Z IY
GERHARD	G ER HH AA R D
GERILAC	JH EH R AH L AH K
GERILACA	JH AH R IH L AH K AH
GERILCI	JH AH R IH L S IY
GESEDAMNAEST	JH EH S AH D AE M N EY AH S T
GIMNAZIJE	JH IH M N AH Z AY JH
GLADI	G L AE D IY
GLAS	G L AE S
GLASA~KA	G L AE S AH
GLASNOGOVORNICE	G L AE Z N AA G AH V AO R N AH S
GLASNOGOVORNIK	G L AE Z N AH G AH V AO R N AH K
GLASOVA	G L AE S AH V AH
GLASOVALA	G L AH S AA V AH L AH
GLASOVE	G L AH S OW V
GLASUJU	G L AH S UW JH UW
GLAVNA	G L AE V N AH
GLAVNE	G L AE V N
GLAVNI	G L AE V N IY
GLAVNIH	G L AE V N IY
GLAVNIM	G L AE V N AH M
GLAVNO	G L AE V N OW
GLAVNOGA	G L AE V N AH G AH
GLAVNOJ	G L AE V N AH JH
GLAVNOM	G L AE V N AH M
GLAVNOME	G L AE V N OW M
GLAVOBOLJE	G L AE V AH B OW L JH
GLAVOBOLJU	G L AE V AH B OW L JH UW
GLAVU	G L AE V UW
GLAZBA	G L AE Z AH
GLAZBENICI	G L AE Z EH N AH S IY
GLAZBENU	G L AE Z AH N UW
GLOBUS	G L OW B AH S
GLOBUSA	G L AA B Y UW S AH
GLOBUSI	G L AA B Y AH S IY
GLUMICU	G L UW M AH K UW
GOD	G AA D
GODINA	G OW D IY N AH
GODINE	G OW D IY N
GODINI	G AA D AH N IY
GODINU	G AA D AH N UW
GODI{NJE	G OW D IY N JH IY
GODI{NJEG	G OW D IY N JH EH G
GODI{NJICE	G OW D IY N JH AY S
GOJ~ETA	G AA JH
GOLEMI	G AA L AH M IY
GOLFA	G OW L F AH
GONG	G AO NG
GORA	G AO R AH
GORAN	G AO R AH N
GORANA	G AO R AH N AH
GORDANA	G AO R D AE N AH
GORE	G AO R
GORI	G AO R IY
GORICI	G AO R AH S IY
GORJU	G AO R JH UW
GORNJOJ	G AO R N JH AH JH
GORSKI	G AO R S K IY
GORSKIM	G AO R S AH M
GORSKOM	G AO R S AH M
GORSKOME	G AO R S OW M
GORU	G AO R UW
GOSPI^	G AA S IY
GOSPODARSKE	G AA S AH D AH R S
GOSPODARSKI	G OW Z P AA D ER S K IY
GOSPODARSKO	G AA S AH D AA R S OW
GOSPODARSKU	G AA S AH D AA R S UW
GOSPODARSTVA	G AA S AH D AA R S T V AH
GOSTI	G AA S T IY
GOTOVINA	G AH T AA V AH N AH
GOTOVINU	G AH T AA V AH N UW
GOTOVO	G AA T AH V OW
GOVORE^I	G AA V AH R AY
GOVORI	G AA V AH R IY
GOVORILI	G AH V AO R AH L IY
GOVORIO	G AH V AO R IY OW
GRAD	G R AE D
GRADA	G R AE D AH
GRADI	G R AE D IY
GRADNJE	G R AE D N JH
GRADNJU	G R AE D N JH UW
GRADONA~ELNICA	G R AE D AH N AH
GRADONA~ELNIK	G R AE D AH N AH
GRADONA~ELNIKOM	G R AE D AH N AH
GRADOVA	G R AE D AH V AH
GRADOVIMA	G R AH D AA V AH M AH
GRADSKA	G R AE D S K AH
GRADSKE	G R AE D S K
GRADSKIM	G R AE D S K AH M
GRADSKOGA	G R AE D S K AH G AH
GRADSKOM	G R AE D S K AH M
GRADU	G R AE D UW
GRANATOM	G R AE N AH T AH M
GRANICE	G R AE N AH S
GRANI~NOG	G R AE N IY
GRANI~NOME	G R AE N IY
GRANSKOG	G R AE N S AH G
GRAN}INOVOM	G R AE N AH N AA V AH M
GRA}ANA	G R AA AE N AH
GRA}ANI	G R AA AE N IY
GRA}ANIMA	G R AA AE N AH M AH
GRA}ANSKI	G R AA AE N S IY
GREBEN	G R IY B AH N
GREGORIJANSKOM	G R EH G AH R AH JH AE N S AH M
GRIPA	G R IH P AH
GRIPE	G R AY P
GRIPOM	G R IH P AH M
GRIPU	G R IH P UW
GRKOVI^A	G R K AA V IY AH
GRMLJAVINA	G R M L JH AE V AH N AH
GRMLJAVINE	G R M L JH AH V AY N
GRMLJAVINOM	G R M L JH AE V AH N AH M
GROBNICA	G R AA B N AH K AH
GROZNICE	G R AA Z N AH S
GROZNICU	G R AA Z N AH K UW
GRUDALI{TE	G R UW D AH L IY T IY
GUBE	G Y UW B
GUBI	G Y UW B IY
GUBICIMA	G Y UW B IH S AH M AH
GUDELJA	G Y UW D EH L JH AH
GUST	G AH S T
GUVERNER	G Y UW V AH R N AH R
GU`VE	G Y UW V IY
GU`VI	G Y UW V IY
GVANTANAMO	G V AE N T AE N AH M OW
HA	HH AA
HAAGU	HH AA G Y UW
HADEZEA	HH AH D IY Z IY AH
HAENESA	HH IY N AH S AH
HAGU	HH AE G Y UW
HAJDUKA	HH AE JH D Y UW K AH
HAJNC	HH AE JH NG K
HAK	HH AE K
HAKA	HH AE K AH
HAKNA	HH AE K N AH
HAKNOVO	HH AE K N AH V OW
HAMAS	HH AA M AA S
HAMASA	HH AE M AH S AH
HANENOM	HH AE N AH N AH M
HAREDSA	HH AH R EH D S AH
HARVARD	HH AA R V ER D
HATEA	HH EY T IY AH
HATEOM	HH EY T IY AH M
HATEU	HH EY T Y UW
HATEVE	HH AE T IY V
HATEVEU	HH AH T IY V Y UW
HAUARDA	HH AO AA R D AH
HAVARD	HH AE V ER D
HAVIJEROM	HH AH V IH JH AH R AH M
HAZEZEO	HH AH Z IY Z IY OW
HAZEZEOA	HH AE Z AH Z IY OW AH
HA`EU	HH AA Y UW
HA{KA	HH AA K AA
HA{KI	HH AA K IY
HA{KIM	HH AA K IH M
HA{KOME	HH AA K OW M
HEBRANG	HH EH B R AH NG
HEKTARA	HH EH K T AH R AH
HELIKOPTERA	HH EH L AH K AA P T AH R AH
HERCEGOVINE	HH AH R S EH G AH V AY N
HERCEGOVINI	HH AH R S AH G AA V AH N IY
HERKUL	HH AH R K AH L
HEROINOM	HH AH R OY N AH M
HIDROMETEOROLO{KOG	HH IH D R AH M IY T IY AO R AH L OW K AA G
HIDROMETEOROLO{KOGA	HH IH D R AH M IY T IY AO R AH L OW K OW G AH
HILARI	HH IH L AH R IY
HIPER	HH IH P ER
HIPOKRATOVOM	HH IH P AH K R AE T AH V AH M
HIRSI	HH AH R S IY
HITAN	HH AY T AH N
HITNA	HH IH T N AH
HITNE	HH IH T N
HITNOJ	HH IH T N AH JH
HITNU	HH IH T N UW
HJUA	HH JH UW W AH
HLADNA	HH L AE D N AH
HLADNI	HH L AE D N IY
HLADNIJE	HH L AE D N AY JH
HLADNO	HH L AE D N OW
HLADNOM	HH L AE D N AH M
HLADNO^E	HH L AE D N OW
HODO~ASNIKA	HH OW D OW
HODO~ASNI~KI	HH OW D OW
HODO~A{^A	HH OW D OW
HONG	HH AO NG
HONORARA	HH AH N AO R AH R AH
HORVAT	HH AO R V AH T
HOTELIMA	HH AH T EH L AH M AH
HO^E	HH OW
HO^E{	HH OW
HO~EVAR	HH OW
HRABROJ	HH R AE B R AH JH
HRANE	HH R EY N
HRANI	HH R AE N IY
HRANU	HH R AE N UW
HRASTI^	HH R AE S T IY
HRISTOS	HH R IH S T AH Z
HRVATA	HH R V AE T AH
HRVATE	HH R V EY T
HRVATICA	HH R V AE T AH K AH
HRVATSKA	HH R V AE T S AH
HRVATSKE	HH R V AE T S
HRVATSKI	HH R V AE T S IY
HRVATSKIH	HH R V AE T S IY
HRVATSKIM	HH R V AE T S AH M
HRVATSKO	HH R V AE T S OW
HRVATSKOBO{NJA~KOM	HH R V AE T S AH B OW N JH AA
HRVATSKOG	HH R V AE T S AH G
HRVATSKOGA	HH R V AE T S AH G AH
HRVATSKOJ	HH R V AE T S AH JH
HRVATSKOM	HH R V AE T S AH M
HRVATSKOME	HH R V AE T S OW M
HRVATSKU	HH R V AE T S UW
HRVOJE	HH R V OW JH
HUSEINA	HH Y UW S IY N AH
HVARA	HH V AE R AH
HVARU	HH V AE R UW
I	AY
IAKO	AY AH K OW
IDENTIFICIRATI	AH D EH N T AH F AH S IH R AH T IY
IDU^E	IH D UW
IDU^EM	IH D UW EH M
IDU^IH	IH D UW IY
IGARA	IH G AH R AH
IGIT	IH JH AH T
IGOR	IH G AO R
IGOR(2)	IY G AO R
IGRU	IH G R UW
IH	IY
ILEGALAN	AH L EH G AH L AH N
ILEGALNOG	IH L AH G AE L N AH G
ILI	IH L IY
ILI^A	IH L IY AH
ILOK	IH L AH K
IM	IH M
IMA	AH M AA
IMAJU	AH M AE JH UW
IMALA	AH M AE L AH
IMALI	AH M AE L IY
IMAMO	AH M AE M OW
IMAO	AH M EY OW
IMATI	AH M AE T IY
IME	IH M
IMENA	IH M AH N AA
IMENOVATI	AH M AH N AA V AH T IY
IMOVINSKU	AH M AH V IH N S UW
IMPULSI	IH M P UH L S IY
INA~E	AH N AA
INDIJA	IH N D IH JH AH
INDIJE	IH N D AY JH
INDIJI	IH N D IH JH IY
INDIJSKE	IH N D IH JH S K
INDIJSKIM	IH N D IH JH S K AH M
INDIJSKOM	IH N D IH JH S K AH M
INDIJSKOME	IH N D IH JH S K OW M
INDIPENDANT	IH N D IH P EH N D AH N T
INDIPENDENT	IH N D IH P EH N D AH N T
INDIPENDENTA	IH N D IH P AH N D EH N T AH
INDIVIDUALNIH	IH N D AH V IH D Y UW AE L N IY
INDONEZIJA	IH N D AH N EH Z AH JH AH
INDONEZIJE	IH N D AA N AH Z AY JH
INDONEZIJI	IH N D AH N EH Z AH JH IY
INDONEZIJSKA	IH N D AA N AH Z IH JH S K AH
INDONEZIJSKOG	IH N D AA N AH Z IH JH S K AH G
INDONEZIJSKOJ	IH N D AA N AH Z IH JH S K AH JH
INDONEZIJSKOM	IH N D AA N AH Z IH JH S K AH M
INDONE`ANA	IH N D AH N AE N AH
INDUSTRIJSKI	IH N D AH S T R IH JH S K IY
INDUSTROGRADNJE	IH N D AH S T R AA G R AH D N JH
INFO	IH N F OW
INFORMACIJA	IH N F AO R M AE S AH JH AH
INFORMACIJAMA	IH N F AO R M AH S IH JH AH M AH
INFORMACIJE	IH N F AO R M AH S AY JH
INFORMACIJI	IH N F AO R M AE S AH JH IY
INFORMACIJSKI	IH N F AO R M AH S IH JH S K IY
INFORMATI~ARA	IH N F AO R M AH T IY
INFORMATI~ARI	IH N F AO R M AH T IY
INFORMATI~KA	IH N F AO R M AH T IY
INFORMATI~KIH	IH N F AO R M AH T IY
INFORMATI~KOJ	IH N F AO R M AH T IY
INSPEKCIJA	IH N S EH K S AH JH AH
INSPEKCIJE	IH N S EH K S AY JH
INSPEKCIJSKA	IH N S EH K S IH JH S K AH
INSPEKTOR	IH N S EH K T AH R
INSTITUCIJE	IH N S T IH T Y AH S AY JH
INSTITUCIONALNA	IH N S T AH T Y UW S IY AH N AE L N AH
INTEGRACIJAMA	IH N T EH G R AH S IH JH AH M AH
INTEGRACIJE	IH N T EH G R AH S AY JH
INTENZITETOM	IH N T EH N Z IH T AH T AH M
INTENZIVNO	IH N T EH N Z IH V N OW
INTERES	IH N T IY R Z
INTERESIMA	IH N T AH R EH S AH M AH
INTERESOM	IH N T AH R EH S AH M
INTERNETA	IH N T AH R N EH T AH
INTERNETSKE	IH N T AH R N EH T S
INTERNETU	IH N T AH R N EH T UW
INTERVENCIJA	IH N T AH R V EH N S AH JH AH
INTERVENCIJE	IH N T AH R V EH N S AY JH
INTERVENCIJU	IH N T AH R V EH N S AH JH UW
INTERVENTNA	IH N T AH R V EH N T N AH
INTERVJUU	IH N T AH R V UW AH
INVALIDA	IH N V AE L AH D AH
INZBRUKU	IH N Z R UW K UW
INZISTIRAJU	IH N Z IH S T IH R AH JH UW
IPAK	IH P AH K
IRAK	IH R AH K
IRAKA	IH R AH K AH
IRAKU	IH R AH K UW
IRA~KA	IH R AH
IRA~KE	IH R AH
IRA~KI	IH R AH
IRA~KIM	IH R AH
IRA~KO	IH R AH
IRA~KOG	IH R AH
IRA~KOGA	IH R AH
IRA~KOM	IH R AH
IRA~KOME	IH R AH
IRA~KU	IH R AH
IRSKOGA	AH R S AH G AH
ISKAZALI	IH S AE Z AH L IY
ISKLJU~IVO	IH S L JH UW
ISKORIJENITI	IH S AH R AH JH EH N AH T IY
ISKORISTITI	IH S AH R IH S T AH T IY
ISKORI{TAVAJU	IH S AH R IY T AE V AH JH UW
ISKORI{TAVAO	IH S AH R IY T AE V EY OW
ISKRENIM	IH S R AH N AH M
ISKUSTVO	IH S AH S T V OW
ISLAMA	IH Z L AH M AH
ISLAMISTIMA	IH Z L AH M IH S T AH M AH
ISLAMISTI~KA	IH Z L AH M IH S T IY
ISLAMISTI~KE	IH Z L AH M IH S T IY
ISLAMISTI~KI	IH Z L AH M IH S T IY
ISLAMISTI~KIM	IH Z L AH M IH S T IY
ISLAMISTI~KOG	IH Z L AH M IH S T IY
ISLAMSKE	IH Z L AH M S
ISLAMSKI	AY Z L AE M S K IY
ISLAMSKIH	IH Z L AE M S IY
ISMAIL	IH S M EY L
ISPALA	IH S AH L AH
ISPITANIKA	IH S AH T AE N AH K AH
ISPITIVANJA	IH S AH T AH V AE N JH AH
ISPITIVANJE	IH S IH T AH V AH N JH
ISPITIVANJIMA	IH S AH T AH V AE N JH AH M AH
ISPITIVANJU	IH S AH T AH V AE N JH UW
ISPLATITI	IH S L AE T AH T IY
ISPLATIVOST	IH S L AE T AH V AH S T
ISPLA^ENE	IH S L AH IH N
ISPRAVNO	IH S R AE V N OW
ISPRED	IH S AH R D
ISPRI~ANA	IH S R IY
ISPROVOCIRANE	IH S R AH V AA S AH R EY N
ISPUNI	IH S Y AH N IY
ISPUNILA	IH S Y UW N AH L AH
ISPUNITI	IH S Y UW N AH T IY
ISPUSTILA	IH S AH S T AH L AH
ISPU{TEN	IH S UW T EH N
ISTA	IH S T AH
ISTAKNULA	IH S T AH K N Y UW L AH
ISTAKNUO	IH S T AE K N Y UW OW
ISTAMBULU	IH S T AH M B Y UW L UW
ISTANBULU	IH S T AH N B Y UW L UW
ISTE	AY S T
ISTI	IH S T IY
ISTINU	IH S T AH N UW
ISTI~E	IH S T IY
ISTI~U	IH S T IY
ISTI~U^I	IH S T IY
ISTJECAO	IH S T JH EH K EY OW
ISTJE~E	IH S T JH
ISTO	IH S T OW
ISTODOBNO	IH S T AH D AA B N OW
ISTOG	AY Z T AA G
ISTOGA	IH S T AH G AH
ISTOK	IH S T AH K
ISTOKA	IH S T AH K AH
ISTOKU	IH S T AH K UW
ISTOME	AY Z T OW M
ISTOVRSNE	IH S T AH V R S N
ISTO~NIM	IH S T OW
ISTO~NJAK	IH S T OW
ISTO~NOJ	IH S T OW
ISTO~NOM	IH S T OW
ISTRA	IH S T R AH
ISTRAGA	IH S T R AH G AH
ISTRAGE	IH S T R AH JH
ISTRAGU	IH S T R AE G Y UW
ISTRA`I	IH S T R AH AY
ISTRA`ITELJA	IH S T R AH AH T EH L JH AH
ISTRA`IVANJE	IH S T R AH IH V AH N JH
ISTRA`NI	IH S T R AH N IY
ISTRA`NOM	IH S T R AH N AA M
ISTRA`UJU	IH S T R AH Y UW JH UW
ISTRE	IH S T ER
ISTRGNUTE	IH S T R G N Y UW T
ISTRI	IH S T R IY
ISTVUD	IH S T V AH D
ITALIJA	AH T AE L AH JH AH
ITALIJE	IH T AH L AY JH
ITALIJI	AH T AE L AH JH IY
ITALIJOM	AH T AE L AH JH AH M
IVAN	AY V AH N
IVANA	IH V AA N AH
IVANE	IH V AH N
IVANKA	AH V AE NG K AH
IVANKOVI^A	AH V AE NG K AH V IY AH
IVANOV	IH V AH N AA V
IVAN~I^	AY V AH N
IVE	AY V
IVICA	IH V AH K AH
IVICE	AY V AH S
IVO	AY V OW
IVOM	IH V AH M
IZ	IH Z
IZA	IH Z AH
IZABRAN	AH Z AE B R AH N
IZABRATI	AH Z AE B R AH T IY
IZASLANSTVO	IH Z AH Z L AE N S T V OW
IZAZVALA	AH Z AE Z AH L AH
IZAZVAO	AH Z AE Z EY OW
IZAZVATI	AH Z AE Z AH T IY
IZA{LO	IH Z AH L OW
IZBACIVATI	IH Z AH S IH V AH T IY
IZBA~EN	IH Z AH
IZBJEGAVANJE	IH Z EH G AH V AH N JH
IZBJEGLE	IH Z AH G AH L
IZBOR	IH Z AH R
IZBORA	IH Z AH R AH
IZBORE	IH Z AH R
IZBORI	IH Z AH R IY
IZBORIMA	IH Z AO R AH M AH
IZBORNA	IH Z AO R N AH
IZBORNE	IH Z AH R N
IZBORNI	IH Z AO R N IY
IZBORNIH	IH Z AO R N IY
IZBORNO	IH Z AO R N OW
IZBORNOG	IH Z AO R N AH G
IZBORNOGA	IH Z AO R N AH G AH
IZBORU	IH Z AH R UW
IZDANJU	IH Z D AE N JH UW
IZDVAJA	IH Z D AH JH AH
IZDVAJAMO	IH Z D AE JH AH M OW
IZDVAJANJA	IH Z D AH JH AE N JH AH
IZDVOJENIM	IH Z D AA JH AH N AH M
IZDVOJITI	IH Z D AA JH AH T IY
IZETBEGOVI^	IH Z AH T B EH G AH V IY
IZGLEDI	IH Z L AH D IY
IZGORJELO	IH Z AO R JH AH L OW
IZGRADITI	IH Z R AE D AH T IY
IZGRADNJA	IH Z R AE D N JH AH
IZGRADNJI	IH Z R AE D N JH IY
IZGRED	IH Z AH R D
IZGREDA	IH Z R AH D AH
IZGREDI	IH Z R AH D IY
IZGREDIMA	IH Z R EH D AH M AH
IZGUBILA	IH Z Y UW B AH L AH
IZI^I	IH Z IY AY
IZJASNILO	IH Z AE Z N AH L OW
IZJAVA	IH Z AH V AH
IZJAVE	IH Z EY V
IZJAVILA	IH Z AE V AH L AH
IZJAVIO	IH Z EY V IY OW
IZJAVLJIVALA	IH Z AH V L JH IH V AH L AH
IZJAVLJUJE	IH Z AH V L JH UW JH
IZJAVU	IH Z AH V UW
IZLAGATI	IH Z L AE G AH T IY
IZLAZE	IH Z L EY Z
IZLAZI	IH Z L AH Z IY
IZLETE	IH Z L IY T
IZLO`BE	IH Z L OW B IY
IZLO`BU	IH Z L OW B UW
IZLO`ENE	IH Z L OW IH N
IZME}U	IH Z M UW
IZMJENAMA	IH Z M JH EH N AH M AH
IZMJENE	IH Z M JH IY N
IZNAD	IH Z N AH D
IZNIJET	IH Z N AH JH AH T
IZNIMNO	IH Z N IH M N OW
IZNOS	IH Z N AH Z
IZNOSE	IH Z N OW Z
IZNOSI	IH Z N AH S IY
IZNOSU	IH Z N AH S UW
IZOLACIJI	IH Z AH L AE S AH JH IY
IZOSTALO	AH Z AA S T AH L OW
IZRADA	IH Z R AH D AH
IZRADI	IH Z R AH D IY
IZRAELACA	IH Z R IY L AH K AH
IZRAELCE	IH Z R IY L S
IZRAELCI	IH Z R IY L S IY
IZRAELOM	IH Z R IY L AH M
IZRAELSKA	IH Z R IY L S AH
IZRAELSKI	IH Z R IY L S IY
IZRAELSKIH	IH Z R IY L S IY
IZRAELSKIM	IH Z R IY L S AH M
IZRAELSKOG	IH Z R IY L S AH G
IZRAELSKOJ	IH Z R IY L S AH JH
IZRAELSKOM	IH Z R IY L S AH M
IZRAZILO	IH Z R AE Z AH L OW
IZRA`AVAO	IH Z R AH AE V EY OW
IZRA`ENE	IH Z R AH IH N
IZRA}UJE	IH Z R AH Y UW JH IY
IZREKAO	IH Z R EH K EY OW
IZRU~ENJEM	IH Z R UW
IZRU~I	IH Z R UW
IZUZETO	AH Z UW Z AH T OW
IZVANREDNE	IH Z AE N R AH D N
IZVANREDNIM	IH Z AH N R EH D N AH M
IZVANREDNO	IH Z AH N R EH D N OW
IZVELA	IH Z AH L AH
IZVIDA	IH Z AH D AH
IZVIJESTILA	IH Z AH JH EH S T AH L AH
IZVIJESTIO	IH Z AH JH EH S T IY OW
IZVJE{TAJ	IH Z T AE JH
IZVJE{TAJI	IH Z T AE JH IY
IZVJE{^A	IH Z AH
IZVJE{^E	IH Z
IZVJE{^U	IH Z UW
IZVJE{^UJE	IH Z Y UW JH IY
IZVORE	IH Z AH R
IZVORI	IH Z AH R IY
IZVORIMA	IH Z AO R AH M AH
IZVR{ILA	IH Z R IH L AH
IZVR{ITI	IH Z R IH T IY
IZVUKU	IH Z Y UW K UW
IZVU~EN	IH Z UW
JA	Y AA
JABLANAC	JH AE B L AH N AH K
JADRAN	JH AE D R AH N
JADRANA	JH AE D R AH N AH
JADRANKA	JH AE D R AE NG K AH
JADRANKE	JH AE D R AH NG K
JADRANKO	JH AE D R AE NG K OW
JADRANOM	JH AE D R AH N AH M
JADRANSKOJ	JH AE D R AE N S AH JH
JADRANU	JH AE D R AH N UW
JADROLINIJE	JH AE D R AA L AH N AY JH
JAJI^	JH AE JH IY
JAK	JH AE K
JAKA	JH AE K AH
JAKIM	JH AE K AH M
JAKO	JH AE K OW
JAKOM	JH AE K AH M
JAKOST	JH AE K AH S T
JAKOSTI	JH AH K AA S T IY
JAKU	JH AE K UW
JAMSTAVA	JH AE M S T AH V AH
JAMSTVO	JH AE M S T V OW
JANEZ	JH AE N AH Z
JANUKOVI^	JH AE N Y UW K AH V IY
JANUKOVI^A	JH AE N Y UW K AH V IY AH
JAN{A	JH AE N AH
JAPAN	JH AH P AE N
JAPANSKE	JH AE P AH N S
JAPANU	JH AE P AH N UW
JASENOVAC	JH AH S EH N AH V AH K
JASER	JH EY Z AH R
JASERA	JH AE S AH R AH
JASEROM	JH AE S AH R AH M
JASNIJIH	JH AE Z N AH JH IY
JASNU	JH AE Z N UW
JAVILA	JH AE V AH L AH
JAVLJA	JH AE V L JH AH
JAVLJAJU	JH AE V L JH AH JH UW
JAVLJANJA	JH AE V L JH AE N JH AH
JAVLJAT	JH AE V L JH AH T
JAVNIM	JH AE V N AH M
JAVNOGA	JH AE V N AH G AH
JAVNOJ	JH AE V N AH JH
JAVNOST	JH AE V N AH S T
JAVNOSTI	JH AE V N AA S T IY
JA~A	JH AA
JA~ANJA	JH AA
JA~ANJE	JH AA
JA~ANJU	JH AA
JA~ATI	JH AA
JA~E	JH AA
JA~INE	JH AA
JE	JH IY
JEDAN	JH IY D AH N
JEDANAEST	JH AH D AE N EY AH S T
JEDANAESTEROKATNICA	JH AH D AH N IY S T AH R AH K AE T N AH K AH
JEDANAESTOG	JH EH D AH N IY S T AH G
JEDANAESTOGODI{NJI	JH EH D AH N IY S T AA G AH D IY N JH IY
JEDANPUT	JH AH D AE N P AH T
JEDINA	JH EH D AH N AH
JEDINICA	JH AH D IH N AH K AH
JEDINICE	JH EH D AH N AH S
JEDINSTVENA	JH AH D IH N S T V AH N AH
JEDINSTVENOJ	JH AH D IH N S T V AH N AH JH
JEDJOT	JH EH JH AH T
JEDNA	JH EH D N AH
JEDNIM	JH EH D N AH M
JEDNO	JH EH D N OW
JEDNODOMNI	JH EH D N AH D AA M N IY
JEDNOG	JH EH D N AH G
JEDNOGA	JH EH D N AH G AH
JEDNOM	JH EH D N AH M
JEDNOSTRANOM	JH EH D N AA S T R AH N AH M
JEDNU	JH EH D N UW
JELA	JH EH L AH
JELI	JH EH L IY
JELI^	JH EH L IY
JER	JH EH R
JERAN	JH IY R AH N
JERUZALEMU	JH EH R AH Z AE L AH M UW
JEST	JH EH S T
JEZIKA	JH EH Z AH K AH
JEZIKU	JH EH Z AH K UW
JOJ	JH AA JH
JONSKIM	JH AA N S AH M
JONSKOME	JH AA N S OW M
JORDAN	JH AO R D AH N
JORDANU	JH AO R D AH N UW
JOSIP	JH AA S AH P
JOZE	JH OW Z
JO{	JH OW
JO{KA	JH OW K AA
JO{KO	JH OW K OW
JUGA	JH UW G AH
JUGO	JH UW G OW
JUGOISTOK	JH UW G OY S T AH K
JUGOISTOKU	JH UW G OY S T AH K UW
JUGOISTO~NE	JH UW G OY S T OW
JUGOISTO~NI	JH UW G OY S T OW
JUGOISTO~NOJ	JH UW G OY S T OW
JUGOISTO~NU	JH UW G OY S T OW
JUGOZAPADA	JH UW G AH Z AE P AH D AH
JUGOZAPADNI	JH UW G AH Z AH P AE D N IY
JUGOZAPADNJAK	JH UW G AH Z AH P AE D N JH AH K
JUGU	JH UW G Y UW
JUKI^	JH UW K IY
JULIJANSKOME	JH UW L IH JH AH N S OW M
JUNAK	JH UW N AH K
JUTARNJA	JH UW T AA R N JH AH
JUTARNJE	JH UW T AH R N JH
JUTARNJEGA	JH UW T AA R N JH AH G AH
JUTRA	JH AH T R AH
JUTROS	JH AH T R AH Z
JUTRO{NJIH	JH AH T R OW N JH IY
JUTRO{NJIM	JH AH T R OW N JH IH M
JUTRO{NJU	JH AH T R OW N JH UW
JUVENTUSA	JH UW V AH N T Y UW S AH
JU`NI	JH UW N IY
JU`NIJE	JH UW N AY JH
JU`NIM	JH UW N IH M
JU`NO	JH UW N OW
JU`NOAZIJSKIM	JH UW N OW Z IH JH S K AH M
JU`NOG	JH UW N AA G
JU`NOGA	JH UW N OW G AH
JU`NOJ	JH UW N AA JH
JU`NOM	JH UW N AA M
JU`NU	JH UW N UW
JU{~ENKA	JH UW
JU{~ENKO	JH UW
JU~ER	JH UW
JU~ERA{NJEG	JH UW
JU~ERA{NJU	JH UW
K	K EY
KABALJEROS	K AH B AE L JH AH R AH Z
KABECEA	K AH B IY S IY AH
KACIGE	K AH S AY JH
KAD	K AE D
KADA	K AE D AH
KAFI^IMA	K AE F IY AH M AA
KAIDA	K EY D AH
KAKO	K AE K OW
KAKVE	K AE K V
KAKVU	K AE K V UW
KALENDARU	K AH L EH N D AH R UW
KALINOV~I^	K AE L AH N AH V
KALORIJA	K AH L AO R AH JH AH
KAMENJA	K AH M EH N JH AH
KAMERA	K AE M AH R AH
KAMIONA	K EY M IY AH N AH
KAMO	K AE M OW
KAMPANJE	K AE M P AH N JH
KAMPANJI	K AE M P AE N JH IY
KAMPHUES	K AE M F Y UW S
KANALU	K AE N AH L UW
KANCELAR	K AE N S AH L AH R
KANDIDAT	K AE N D AH D AH T
KANDIDATA	K AE N D IH D AH T AH
KANDIDATE	K AE N D AH D EY T
KANE	K EY N
KAO	K AW
KAO(2)	K EY OW
KAP	K AE P
KAPACITETA	K AE P AH S IH T AH T AH
KAPELA	K AE P AH L AH
KAPELAN	K AE P AH L AH N
KAPELE	K EY P IY L
KAPELI	K AE P AH L IY
KAPELICI	K AH P EH L AH S IY
KAPRALJEVI^	K AE P R AE L JH AH V IY
KAPRIO	K AE P R IY OW
KARAKASA	K AH R AE K AH S AH
KARAMARKA	K AE R AH M AA R K AH
KARAMARKO	K AE R AH M AA R K OW
KARIMOVA	K AH R IH M AH V AH
KARITASA	K AH R IH T AH S AH
KARI^	K AE R IY
KARLA	K AA R L AH
KARLI	K AA R L IY
KARLOBAG	K AA R L AH B AH G
KARLOVAC	K AA R L AH V AH K
KARLOVA~KE	K AA R L AH V AH
KARLOVA~KOJ	K AA R L AH V AH
KARLOVCA	K AA R L AA V K AH
KARLOVCU	K AA R L AA V K UW
KAROLINI	K AH R AA L AH N IY
KARTE	K AA R T
KARTU	K AA R T UW
KASNIJE	K AE Z N AY JH
KASNIJEM	K AE Z N AH JH AH M
KATAKLIZME	K AH T AE K L AH Z M
KATAR	K EY T AH R
KATARSKOG	K AH T AA R S AH G
KATASTROFA	K AH T AE S T R AH F AH
KATASTROFALNE	K AH T AE S T R AH F AH L N
KATASTROFE	K AE T AH S T R OW F
KATASTROFI	K AH T AE S T R AH F IY
KATEDRALE	K AE T AH D R EY L
KATEDRALU	K AH T EH D R AH L UW
KATEGORIJI	K AE T AH G AO R AH JH IY
KATOLICI	K AH T AA L AH S IY
KATOLI~KOG	K AE T AH L IY
KATSAV	K AE T S AH V
KATSAVOM	K AE T S AH V AH M
KAZALI{TU	K AE Z AH L IY T UW
KAZNA	K AE Z N AH
KAZNE	K AE Z N
KAZNENA	K AE Z N AH N AH
KAZNENI	K AE Z N AH N IY
KAZNENIM	K AE Z N AH N AH M
KAZNENOG	K AE Z N AH N AH G
KAZNENOGA	K AE Z N EH N AH G AH
KAZNENOJ	K AE Z N AH N AH JH
KAZNENU	K AE Z N AH N UW
KAZNI	K AE Z N IY
KAZNITI	K AE Z N AH T IY
KAZNU	K AE Z N UW
KA`E	K AA
KA`NJAVANI	K AA N JH AE V AH N IY
KA`NJAVATI	K AA N JH AE V AH T IY
KA`NJIVO	K AA N JH IH V OW
KA`U	K AA UW
KA{I^A	K AA AY AH
KEMIKALIJA	K EH M AH K AE L AH JH AH
KERIJA	K EH R AH JH AH
KETERINGA	K EH T AH R IH N G AH
KIDANJA	K AH D AE N JH AH
KILOMETAR	K IH L AH M IY T ER
KILOMETARA	K IH L AH M EH T AH R AH
KILOMETRA	K IH L AH M EH T R AH
KIME	K AY M
KINA	K IH N AH
KINE	K AY N
KINO	K IH N OW
KINU	K IH N UW
KI{A	K IY AH
KI{E	K IY
KI{OM	K IY AA M
KI{U	K IY UW
KLAPA	K L AE P AH
KLASIFIKACIJU	K L AE S AH F AH K AE S AH JH UW
KLASI~NOJ	K L AE S IY
KLINICI	K L IH N AH S IY
KLINI~KIH	K L IH N IY
KLINI~KIM	K L IH N IY
KLINT	K L IH N T
KLJU~NA	K L JH UW
KLOPKU	K L AA P UW
KLOR	K L AO R
KLUB	K L AH B
KLUBA	K L UW B AH
KLUBOM	K L UW B AH M
KNE`EV	N IY EH V
KNINSKOJ	N IH N S AH JH
KNINSKU	N IH N S UW
KNJIZI	N JH IH Z IY
KNJI`NICE	N JH IY N AY S
KOBE	K OW B EY
KOD	K AA D
KOGA	K OW G AH
KOJA	K OW JH AH
KOJE	K OW JH
KOJEG	K AA JH AH G
KOJEGA	K AA JH AH G AH
KOJEM	K AA JH AH M
KOJEMU	K AA JH AH M UW
KOJI	K OW JH IY
KOJIH	K AA JH IY
KOJIM	K AA JH AH M
KOJIMA	K AH Y AY M AH
KOJOJ	K AA JH AH JH
KOJOM	K AA JH AH M
KOJU	K OW JH UW
KOKTEL	K AA K T AH L
KOLEGA	K AA L AH G AH
KOLEGE	K AH L IY JH
KOLEGOM	K AA L AH G AH M
KOLEKTIVNI	K AA L AH K T IH V N IY
KOLEKTIVNIH	K AA L AH K T IH V N IY
KOLEKTIVNOG	K AA L AH K T IH V N AH G
KOLEKTIVNOGA	K AA L AH K T IH V N AH G AH
KOLIKE	K AH L AY K
KOLIKO	K AA L AH K OW
KOLINA	K AA L AH N AH
KOLI~INA	K OW L IY
KOLI~INU	K OW L IY
KOLO	K OW L OW
KOLONA	K AA L AH N AH
KOLONAMA	K AH L AA N AH M AH
KOLONI	K AA L AH N IY
KOLONIJA	K AH L AA N AH JH AH
KOLOVOZA	K AH L AA V AH Z AH
KOMARICA	K AH M AE R AH K AH
KOMEDIJE	K AA M AH D AY JH
KOMEMORACIJI	K AA M AH M AH R AE S AH JH IY
KOMEMORATIVNOJ	K AH M EH M AH R AH T IH V N AH JH
KOMENTIRALI	K AA M AH N T IH R AH L IY
KOMENTIRATI	K AA M AH N T IH R AH T IY
KOMISIJA	K AH M IH S AH JH AH
KOMISIJE	K AA M AH S AY JH
KOMI~NA	K OW M IY
KOMORA	K AA M AH R AH
KOMORE	K AA M AH R
KOMPAS	K AA M P AH Z
KOMPASA	K AA M P AH S AH
KOMPOZICIJE	K AA M P AA Z AH S AY JH
KOMUNIKACIJE	K AA M Y AH N IH K AH S AY JH
KOMUNISTI~KE	K AA M Y AH N IH S T IY
KONA~NE	K OW N AH
KONA~NICI	K OW N AH
KONCENTRACIJI	K AA N S AH N T R AE S AH JH IY
KONCENTRACIJOM	K AA N S AH N T R AE S AH JH AH M
KONCENTRACIJU	K AA N S AH N T R AE S AH JH UW
KONCERT	K AA N S AH R T
KONCERTA	K AA N S AH R T AH
KONCESIJOM	K AA N S EH S AH JH AH M
KONFERENCIJA	K AA N F AH R EH N S AH JH AH
KONFERENCIJE	K AA N F EH R AH N S AY JH
KONFERENCIJI	K AA N F AH R EH N S AH JH IY
KONFERENCIJOM	K AA N F AH R EH N S AH JH AH M
KONG	K AO NG
KONG(2)	K AO NG G
KONGRES	K AA N G AH R Z
KONGRESNIKA	K AA N G R EH Z N AH K AH
KONGU	K AA N G Y UW
KONJI	K AA N JH IY
KONSENZUS	K AA N S EH N Z AH S
KONSTITUIRAJU^E	K AA N S T AH T UW R AH JH UW
KONSTITUTIVAN	K AA N S T AH T Y UW T AH V AH N
KONSTRUTORI	K AA N S T R UW T AH R IY
KONTAKT	K AA N T AH K T
KONTAKTE	K AA N T AH K T
KONTRAVERZNE	K AA N T R AH V AH R Z N
KONTROLIRAJU	K AA N T R AH L IH R AH JH UW
KONTROLIRANA	K AA N T R AH L IH R AH N AH
KONVOJ	K AA N V AH JH
KONZALTINGA	K AA N Z AH L T IH N G AH
KONZULATA	K AA N Z UW L AH T AH
KONZULTACIJE	K AA N Z AH L T AH S AY JH
KOORDINACIJSKI	K UH R D AH N AH S IH JH S K IY
KOORDINATOR	K UH R D AH N EY T AH R
KOP	K AA P
KOPNA	K AA P N AH
KOPNENIM	K AA P N AH N AH M
KOPNENOM	K AA P N AH N AH M
KOPRIVNJAK	K AA P R IH V N JH AH K
KORDI^A	K AO R D IY AH
KOREIJA	K AH R IY JH AH
KORIJERE	K AO R AH JH AH R
KORISNIKE	K AO R AH Z N AY K
KORIST	K AO R AH S T
KORISTE^I	K AH R AY S T AY
KORISTI	K AH R IH S T IY
KORISTILE	K AH R IH S T AH L
KORISTIO	K AH R IH S T IY OW
KORISTITI	K AH R IH S T AH T IY
KORI{TENJE	K AO R IY T EH N JH
KORPAR	K AO R P AH R
KOR~ULI	K AO R
KOSOR	K OW Z AH R
KOSOVSKOGA	K AH S AA V S K AH G AH
KOSOVU	K AA S AH V UW
KOSTAJNICA	K AA S T AE JH N AH K AH
KOSTRUTORI	K AA S T R UW T AH R IY
KOTAR	K OW T AH R
KOTARU	K AA T AH R UW
KOTLINAMA	K AA T L IH N AH M AH
KOTOR	K OW T AH R
KOTORA	K AA T AH R AH
KOTORSKA	K AH T AO R S AH
KOTORSKE	K AA T AH R S
KOTORU	K AA T AH R UW
KO{TALO	K OW T AE L OW
KO{TUNICE	K OW T Y UW N AH S
KRAJA	K R AE JH AH
KRAJEM	K R AE JH AH M
KRAJEVIMA	K R AH JH EH V AH M AH
KRAJNJEG	K R AE JH N JH AH G
KRAJU	K R AE JH UW
KRALJA	K R AE L JH AH
KRALJEVSKIM	K R AE L JH EH V S K AH M
KRANJA	K R AE N JH AH
KRAPINSKO	K R AH P IH N S OW
KRATERA	K R AE T AH R AH
KRATKORO~NU	K R AE T AH R OW
KRATKOTRAJAN	K R AE T AA T R AH JH AH N
KRATKOTRAJNA	K R AE T AH T R AE JH N AH
KRATKOTRAJNE	K R AE T AA T R AH JH N
KRATKOTRAJNI	K R AE T AH T R AE JH N IY
KRATKOTRAJNIH	K R AE T AH T R AE JH N IY
KRATKOTRAJNIM	K R AE T AH T R AE JH N AH M
KRATKOTRAJNOG	K R AE T AH T R AE JH N AH G
KRATKOTRAJNU	K R AE T AH T R AE JH N UW
KRA^A	K R AA AH
KRA^E	K R AA
KRA^EM	K R AA EH M
KRE^E	K AH R
KRE{IMIR	K AH R AH M IH R
KRIJUM~ARENJE	K R IH JH AH M
KRIJUM~ARIMA	K R IH JH AH M
KRILA	K R IH L AH
KRISTALNA	K R IH S T AE L N AH
KRITIKA	K R IH T AH K AH
KRITIZIRAO	K R IH T AH Z IH R EY OW
KRITI~KI	K R IH T IY
KRIVNJU	K R IH V N JH UW
KRIVOTVORENIMA	K R AH V AA T V AH R EH N AH M AH
KRIZA	K R IH Z AH
KRIZMANI^	K R IH Z M AH N IY
KRI`	K R IY
KRI`A	K R IY AH
KROACIJU	K R OW S AH JH UW
KRONI~NI	K R AA N IY
KRONI~NIH	K R AA N IY
KROZ	K R AA Z
KRSNIK	K R S N IH K
KRSNIKA	K R S N IH K AH
KRUG	K R AH G
KRUGA	K R UW G AH
KRUGU	K R UW G Y UW
KRUNO	K R UW N OW
KRVI	K R V IY
KRVO`ILNIM	K R V OW IH L N AH M
KR{E	K R
KR{ENJU	K R IH N JH UW
KR{^ANSKI	K R AE N S IY
KUGLA	K AH G L AH
KUKOVA	K Y UW K AH V AH
KUKU	K Y UW K UW
KULA{	K Y UW L AH
KULTURE	K AH L T Y AH R
KUNA	K Y UW N AH
KUNU	K Y UW N UW
KUPA	K Y UW P AH
KUPI	K Y UW P IY
KUPNJI	K AH P N JH IY
KUPOPRODAJE	K Y UW P AA P R AH D EY JH
KURBAM	K AH R B AH M
KURBAN	K AH R B AH N
KURDA	K AH R D AH
KURDISTAN	K ER D IH S T AE N
KURDISTANU	K AH R D IH S T AH N UW
KURDSKIH	K AH R D S K IY
KUVAJTA	K Y UW V AE JH T AH
KUVAJTSKIH	K Y UW V AE JH T S K IY
KU^ANICE	K UW AH N AY S
KU^E	K UW
KU^I	K UW AY
KU^ICAMA	K UW IH K AH M AH
KU^ICE	K UW AY S
KU^U	K UW UW
KU~ME	K UW
KVADRI	K V AE D R IY
KVARNER	K V AA R N AH R
KVARNERU	K V AA R N AH R UW
LABUSA	L AE B Y UW S AH
LAGANU	L AE G AH N UW
LAGOS	L EY G AO S
LAK{E	L AE K
LANI	L AA N IY
LANJSKE	L AE N JH S K
LANKA	L AE NG K AH
LANKI	L AE NG K IY
LAPAROSKOPSKO	L AE P AH R AH S AA P S OW
LAPAROSKOPSKU	L AE P AH R AH S AA P S UW
LASERA	L AA Z IH R AH
LASERE	L EY S AH R
LATERALE	L EY T ER EY L
LAVROV	L AE V R AH V
LAZARETI	L AH Z AE R AH T IY
LAZARETIMA	L AE Z AH R EH T AH M AH
LEDENE	L AH D IY N
LEGITIMNU	L EH JH AH T IH M N UW
LENAC	L EH N AH K
LENCA	L EH NG K AH
LEONARDO	L IY AH N AA R D OW
LEONIDA	L IY AA N AH D AH
LEPENICI	L AH P EH N AH S IY
LEROJA	L EH R AH JH AH
LET	L EH T
LETJELI	L EH T JH AH L IY
LETJELICA	L EH T JH EH L AH K AH
LEVANT	L AH V AE N T
LI	L IY
LICI	L IH S IY
LIGE	L AY JH
LIGURSKOG	L AH G AH R S AH G
LIJEKOVA	L AH JH EH K AH V AH
LIJEPIH	L IH JH AH P IY
LIJE~ENJA	L AY JH
LIJE~ENJE	L AY JH
LIJE~ENJU	L AY JH
LIJE~ITI	L AY JH
LIJE~NICI	L AY JH
LIJE~NICIMA	L AY JH
LIJE~NIK	L AY JH
LIJE~NIKA	L AY JH
LIJE~NIKE	L AY JH
LIJE~NI~KA	L AY JH
LIJE~NI~KI	L AY JH
LIJE~NI~KOG	L AY JH
LIKOVI	L IH K AH V IY
LIN	L IH N
LIN#O	L IH N OW
LINIJA	L IH N AH JH AH
LINIJAMA	L AH N IH JH AH M AH
LINIJE	L AH N AY JH
LINIJI	L IH N AH JH IY
LINIJU	L IH N AH JH UW
LIPA	L IY P AH
LIPNJA	L IH P N JH AH
LIPNJU	L IH P N JH UW
LIROJ	L IH R AH JH
LISABONU	L AH S AE B AH N UW
LIST	L IH S T
LISTA	L IH S T AH
LISTE	L AY S T
LISTI^A	L IH S T IY AH
LISTOPAD	L IH S T AH P AH D
LISTOPADA	L IH S T AA P AH D AH
LISTOPADU	L IH S T AA P AH D UW
LISTOVI	L IH S T AH V IY
LISTU	L IH S T UW
LITARA	L IH T AH R AH
LI~KOM	L IY
LJESTVICE	L JH EH S T V AH S
LJETNE	L JH EH T N
LJETOVANJE	L JH EH T AH V AH N JH
LJE~NI~KA	L JH IY
LJE~NI~KE	L JH IY
LJUBICA	L JH UW B AH K AH
LJUBITELJE	L JH UW B AH T AH L JH
LJUBITELJIMA	L JH UW B AH T EH L JH AH M AH
LJUBLJANSKA	L JH AH B L JH AE N S AH
LJUBLJANSKE	L JH AH B L JH AH N S
LJUBLJANSKO	L JH AH B L JH AE N S OW
LJUDE	L JH UW D
LJUDI	L JH UW D IY
LJUDIMA	L JH UW D AH M AH
LJUDSKA	L JH AH D S K AH
LJUDSKI	L JH AH D S K IY
LJUDSKIH	L JH AH D S K IY
LJUDSKO	L JH AH D S K OW
LJUDSKOG	L JH AH D S K AH G
LOGISTI~KU	L AH JH IH S T IY
LOGORU	L AA G AH R UW
LOKACIJE	L AA K AH S AY JH
LOKAL	L OW K AH L
LOKALNI	L AH K AE L N IY
LOKALNIM	L AH K AE L N AH M
LOKVU	L AA K V UW
LONDON	L AH N D AH N
LONDONU	L AA N D AH N UW
LON~ARI^	L AA N
LOS	L OW S
LOS(2)	L AO S
LOVRO	L AA V R OW
LO{E	L OW
LO{EGA	L OW EH G AH
LUCI	L UW S IY
LUCI^	L UW S IY
LUKA	L UW K AH
LUKAMA	L UW K AH M AH
LUKE	L UW K
LUKOM	L UW K AH M
LUNAPARK	L UW N AH P AH R K
LU~KE	L UW
LU~KOG	L UW
MA	M AA
MACELJ	M AE S AH L JH
MAESTRAL	M IY S T R AH L
MAGISTRALOM	M AH JH IH S T R AH L AH M
MAGLA	M AE G L AH
MAGLE	M EY G AH L
MAGLOVITA	M AE G L AA V AH T AH
MAGLOVITO	M AE G L AA V AH T OW
MAGNEONSOM	M AE G N IY AA N S AH M
MAGNITUDA	M AE G N AH T Y UW D AH
MAHMUD	M AE M UW D
MAHMUD(2)	M AA M UW D
MAHMUDA	M AE M Y UW D AH
MAJA	M AE JH AH
MAJKEL	M AE JH K AH L
MAKARSKE	M AE K AH R S
MAKARSKOGA	M AH K AA R S AH G AH
MALA	M AA L AH
MALI	M AA L IY
MALIGNOMA	M AH L IH G N AH M AH
MALO	M AA L OW
MALOG	M AE L AH G
MALOLJETNICIMA	M AH L OW L JH AH T N IH S AH M AH
MALOLJETNIKA	M AH L OW L JH EH T N AH K AH
MALOM	M AH L AA M
MALU	M AH L UW
MALVERZACIJA	M AE L V AH R Z AE S AH JH AH
MANDATA	M AE N D AH T AH
MANJA	M AE N JH AH
MANJAK	M AE N JH AH K
MANJE	M AE N JH
MANJEM	M AE N JH AH M
MANJI	M AE N JH IY
MANJIH	M AE N JH IY
MANJINA	M AE N JH AH N AH
MANJINSKA	M AE N JH IH N S AH
MANJU	M AE N JH UW
MAOISTI~KA	M EY OY S T IY
MAOISTI~KI	M EY OY S T IY
MARGINI	M AA R JH AH N IY
MARIJA~I	M AE R AH JH AH
MARIN	M EH R IH N
MARINA	M ER IY N AH
MARINACA	M AH R IH N AH K AH
MARIO	M AA R IY OW
MARK	M AA R K
MARKELJEVI^	M AA R K EH L JH AH V IY
MARKU	M AA R K UW
MARL	M AA R L
MAROKANSKE	M AE R AH K AH N S
MARULI^U	M AH R UW L IY UW
MAR{	M AA R
MAR{I^	M AA R AY
MASOVNIH	M AH S AA V N IY
MASOVNO	M AH S AA V N OW
MASTER	M AE S T ER
MASTERPLANOVE	M AE S T AH R P L AH N OW V
MATERIJALNA	M AE T AH R AH JH AE L N AH
MATERIJALNE	M AH T EH R AH JH AH L N
MATERIJALNU	M AE T AH R AH JH AE L N UW
MATIM	M AE T AH M
MATJEM	M AE T JH AH M
MA}ARSKI	M AA AA R S IY
MA~EK	M AA
MED	M EH D
MEDALJE	M EH D AH L JH
MEDALJU	M AH D AE L JH UW
MEDICINSKA	M EH D AH S IH N S AH
MEDICINSKE	M EH D AH S AH N S
MEDICINSKIH	M EH D AH S IH N S IY
MEDICINSKOJ	M EH D AH S IH N S AH JH
MEDIJE	M AH D AY JH
MEDIJI	M EH D AH JH IY
MEDIJSKE	M EH D AH JH S K
MEDVJED	M EH D
MEKE	M IY K
MEKU	M EH K UW
MEK{EJN	M EH K EH JH N
MERKALIJEVE	M AH R K AE L AH JH IY V
MESA	M EY S AH
MESI^	M EH S IY
MESI^A	M EH S IY AH
MESI^EM	M EH S IY EH M
MESI^EVU	M EH S IY EH V UW
MESI^U	M EH S IY UW
METARA	M EH T AH R AH
METE	M IY T
METE(2)	M EH T AH
METEOROLO{KOG	M IY T IY AO R AH L OW K AA G
METEOROLO{KOGA	M IY T IY AO R AH L OW K OW G AH
METEOROPATI	M IY T IY AH R AA P AH T IY
METKOVI^	M EH T AH V IY
METODE	M AH T OW D
METROPOLI	M AH T R AA P AH L IY
ME{IHATE	M IY IH EY T
ME}IMURSKOM	M IY AH M AH R S AH M
ME}U	M IY UW
ME}UGENERACIJSKE	M IY Y UW JH AH N EH R AH S AH JH S K
ME}UNARODNE	M IY AH N AE R AH D N
ME}UNARODNIH	M IY AH N AH R AA D N IY
ME}UNARODNIM	M IY AH N AH R AA D N AH M
ME}UNARODNOG	M IY AH N AH R AA D N AH G
ME}UNARODNOGA	M IY AH N AH R AA D N AH G AH
ME}UNARODNOJ	M IY AH N AH R AA D N AH JH
ME}UNARODNOM	M IY AH N AH R AA D N AH M
ME}UNARODNU	M IY AH N AH R AA D N UW
ME}USOBNI	M IY Y UW S AA B N IY
ME}USOBNIH	M IY Y UW S AA B N IY
ME}USOBNO	M IY Y UW S AA B N OW
ME}UTIM	M IY Y UW T AH M
ME}UVREMENU	M IY AH V R EH M AH N UW
MICANJE	M IH K AH N JH
MIHAJLOVI^A	M AH HH AE JH L AH V IY AH
MIHOLJAC	M AH HH OW L JH AH K
MIJENJA	M AH JH EH N JH AH
MIJE{ANJE	M AY JH AE N JH
MIKE	M AY K
MIKO	M AY K OW
MIKULI^	M IH K Y AH L IY
MIKULI^A	M IH K Y AH L IY AH
MILENA	M IH L AH N AH
MILI	M IH L IY
MILIJARDE	M IH L AH JH AH R D
MILIJARDI	M IH L AH JH AA R D IY
MILIJARDU	M IH L AH JH AA R D UW
MILIJUN	M IH L AH JH AH N
MILIJUNA	M IH L AH JH UW N AH
MILIJUNIMA	M IH L AH JH UW N AH M AH
MILITANATA	M IH L AH T AE N AH T AH
MILITANTNIH	M IH L AH T AE N T N IY
MILJN	M IH L JH N
MIMOHODA	M AH M AA HH AH D AH
MINA	M IY N AH
MINA(2)	M IH N AH
MINI	M IH N IY
MINIGO	M IH N IY G OW
MINIMUM	M IH N AH M AH M
MINIRANIH	M AH N AH R AE N IY
MINISTAR	M IH N IY S T AA R
MINISTARSTVA	M AH N IY S T AA R S T V AH
MINISTARSTVO	M AH N IY S T AA R S T V OW
MINISTARSTVU	M AH N IY S T AA R S T V UW
MINISTRA	M IH N IY S T R AA
MINISTRI	M IH N IY S T R IY
MINISTRICA	M AH N IY S T R IH K AH
MINISTRICE	M AY N IH S T R AY S
MINSKI	M IH N S IY
MINSKIH	M IH N S IY
MINSTERU	M IH N S T AH R UW
MINUS	M AY N AH S
MINUTA	M IH N Y UW T AH
MINUTE	M IH N AH T
MINUTE(2)	M AY N UW T
MINUTE(3)	M AY N Y UW T
MINUTOM	M IH N Y UW T AH M
MINUTU	M IH N Y UW T UW
MIOMIR	M AY AH M AH R
MIOMIRA	M AY AA M AH R AH
MIOMIROM	M AY AA M AH R AH M
MIR	M IH R
MIRA	M IH R AH
MIRENJA	M AH R EH N JH AH
MIRJANA	M AH R JH AH N AH
MIRJANE	M AH R JH EY N
MIRNO	M AH R N OW
MIRNOGA	M AH R N AH G AH
MIROLJUBA	M IH R OW L JH UW B AH
MIROSLAVOM	M AH R AA Z L AH V AH M
MIROVNE	M IH R AH V N
MIROVNIH	M AH R AA V N IY
MIROVNIM	M AH R AA V N AH M
MIROVNU	M AH R AA V N UW
MIRU	M IH R UW
MISE	M IH S
MISI	M AH S IY
MISIJA	M AH S IH JH AH
MISIJE	M AH S AY JH
MISIJU	M AH S IH JH UW
MISLIMA	M IH S L IH M AH
MISU	M AH S UW
MI{LJENJA	M IY L JH EH N JH AH
MI{LJENJE	M IY L JH EH N JH
MI{LJENJU	M IY L JH EH N JH UW
MJERA	M JH EH R AH
MJERE	M JH IH R
MJESEC	M JH EH S AH K
MJESECA	M JH EH S AH K AH
MJESECI	M JH EH S AH S IY
MJESE~NA	M JH IY Z
MJESE~NE	M JH IY Z
MJESTA	M JH EH S T AH
MJESTIMA	M JH EH S T AH M AH
MJESTIMICE	M JH EH S T AH M AH S
MJESTIMI~NOM	M JH EH S T AH M IY
MJESTIMI~NU	M JH EH S T AH M IY
MJESTO	M JH EH S T OW
MJESTU	M JH EH S T UW
MJE{TANIMA	M JH IY T AE N AH M AH
MJUZIKLA	M JH UW Z IH K L AH
MLADE`	M L EY D
MLADE{KU	M L EY D K UW
MLADI	M L AE D IY
MLADIH	M L AE D IY
MLADI^	M L AE D IY
MLADI^A	M L AE D IY AH
MLA}E	M L AA
MLIJEKA	M L IH JH AH K AH
MNOGE	M N OW JH
MNOGI	M N AA JH IY
MNOGIM	M N AA JH AH M
MNOGO	M N AA G OW
MNOGOBROJNE	M N AH G AA B R AH JH N
MNO{TVO	M N OW T V OW
MOBILNIH	M AH B IH L N IY
MODEL	M AA D AH L
MODERNA	M AH D AH R N AH
MODERNE	M OW D EH R N
MODERNIZACIJI	M AH D AH R N AH Z AE S AH JH IY
MOGAO	M AA G EY OW
MOGLA	M AA G L AH
MOGLE	M OW G AH L
MOGLI	M AA G L IY
MOGLO	M AA G L OW
MOGU	M OW G Y UW
MOGU^	M OW G Y UW
MOGU^A	M OW G Y UW AH
MOGU^E	M OW G Y UW
MOGU^EG	M OW G Y UW EH G
MOGU^I	M OW G Y UW AY
MOGU^NOST	M OW G Y UW N AA S T
MOGU^NOSTI	M OW G Y UW N AA S T IY
MOGU^OJ	M OW G Y UW AA JH
MOJ	M AA JH
MOJA	M OW JH AH
MOJE	M OW JH
MOJSIJU	M AA JH S AH JH UW
MOKORI^	M AA K AH R IY
MOLE^I	M OW L AY
MOLI	M OW L IY
MOLITI	M AA L AH T IY
MOLITVAMA	M AH L IH T V AH M AH
MOLITVU	M AH L IH T V UW
MONARHIJE	M AA N AH R AY JH
MONTGOMERI	M AA N T G AA M AH R IY
MONTGOMERIJA	M AA N T G AH M EH R AH JH AH
MONTGOMERIJEVE	M AA N T G AH M EH R AH JH IY V
MONTGOMERIJU	M AA N T G AH M EH R AH JH UW
MORA	M AO R AH
MORAJU	M AO R AH JH UW
MORATI	M AO R AH T IY
MORE	M AO R
MOREM	M AO R AH M
MORNARICA	M AO R N AE R AH K AH
MORU	M AO R UW
MOSKOVSKOGA	M AA S AA V S K AH G AH
MOSLAVA~KOM	M AA Z L AH V AH
MOSTARU	M AA S T AH R UW
MOSULA	M AH S UW L AH
MOTORKOTA~IMA	M AH T AO R K AH T AH
MO^I	M OW AY
MO`DA	M OW D AA
MO`E	M OW
MO{E	M OW
MO{OM	M OW AA M
MRAZA	M R AE Z AH
MRTVA~NICE	M R T V AA
MRTVIH	M R T V IY
MRZLJAK	M R Z L JH AE K
MU	M UW
MU#AHEDINIMA	M UW AE HH AH D IH N AH M AH
MUFTI	M AH F T IY
MUHAMED	M UH HH AA M EH D
MUKA	M Y UW K AH
MUSLIMANA	M AH Z L IH M AH N AH
MUSLIMANI	M AH Z L IH M AH N IY
MUSLIMANSKA	M AH Z L AH M AE N S AH
MUSLIMANSKE	M AH Z L AH M AH N S
MUSLIMANSKIM	M AH Z L AH M AE N S AH M
MUSLIMANSKOHRVATSKI	M AH Z L AH M AE N S AH R V AE T S IY
MUSTAFA	M UW S T AA F AH
MUZEJU	M Y UW Z AH JH UW
MU{KARCA	M UW K AA R K AH
MU~ENIKA	M UW
MU~NIH	M UW
NA	N AA
NACIONALISTIMA	N EY S IY AH N AH L IH S T AH M AH
NACIONALNE	N EY S IY AH N AH L N
NACIONALNIH	N EY S IY AH N AE L N IY
NACIONALNOG	N EY S IY AH N AE L N AH G
NACIONALNOJ	N EY S IY AH N AE L N AH JH
NACIONALNOM	N EY S IY AH N AE L N AH M
NACIONALNU	N EY S IY AH N AE L N UW
NACRT	N AE K R T
NACRTU	N AE K R T UW
NAD	N AE D
NADA	N AA D AA
NADBISKUP	N AE D IH S AH P
NADLE`NA	N EY D AH L N AA
NADLE`NOSTI	N EY D AH L N AA S T IY
NADZEMNA	N AE D Z EH M N AH
NADZIRE	N AE D Z AY R
NADZIRU	N AE D Z AH R UW
NADZOR	N AE D Z AH R
NADZOROM	N AE D Z AH R AH M
NAGA}ANJA	N AE G AH AE N JH AH
NAGLAVA~KE	N AE G L AA V AH
NAGRA}ENA	N AE G R AH AH N AA
NAIME	N EY M
NAIZMJENCE	N EY Z M JH AH N S
NAJAVILA	N AH JH AE V AH L AH
NAJAVILE	N AH JH EY V AH L
NAJAVILI	N AH JH AE V AH L IY
NAJAVIO	N AH JH EY V IY OW
NAJAVLJEN	N AH JH AE V L JH AH N
NAJAVLJUJU	N AE JH AH V L JH UW JH UW
NAJBLI`E	N AE JH L IY
NAJBLI`IH	N AE JH L IY IY
NAJBOLJA	N AE JH OW L JH AH
NAJBOLJE	N AE JH OW L JH
NAJBOLJEG	N AE JH OW L JH AH G
NAJBOLJI	N AE JH OW L JH IY
NAJBOLJIH	N AE JH OW L JH IY
NAJBOLJU	N AE JH OW L JH UW
NAJGORE	N AE JH AH R
NAJISTO~NIJIM	N AH JH IH S T OW
NAJKASNIJE	N AE JH K AH Z N AY JH
NAJMANJE	N AE JH M AH N JH
NAJMLA}E	N AE JH M L AH
NAJNI`A	N AE JH N IY AH
NAJNOVIJE	N AE JH N AH V AY JH
NAJNOVIJEM	N AE JH N AA V AH JH AH M
NAJNOVIJI	N AE JH N AA V AH JH IY
NAJNOVIJU	N AE JH N AA V AH JH UW
NAJOSJETLJIVIJI	N AH JH AA Z AH T L JH IH V AH JH IY
NAJPOZNATIJOJ	N AE JH P AH Z N AE T AH JH AH JH
NAJPRIJE	N AE JH P R AY JH
NAJRAZVIJENIJIH	N AE JH R AE Z AH JH EH N AH JH IY
NAJTE`E	N AE JH T
NAJVA`NIJA	N AE JH AH N IH JH AH
NAJVA`NIJE	N AE JH AH N AY JH
NAJVE^A	N AE JH AH
NAJVE^E	N AE JH
NAJVE^EG	N AE JH EH G
NAJVE^I	N AE JH AY
NAJVE^IM	N AE JH IH M
NAJVI{A	N AE JH IY AH
NAJVI{E	N AE JH IY
NAJVI{OM	N AE JH IY AA M
NAJVJEROJATNIJE	N AE JH AH R AA JH AH T N AY JH
NAJVJEROVATNIJE	N AE JH AH R AA V AH T N AY JH
NAKNADE	N AE K N EY D
NAKNADNO	N AE K N AE D N OW
NAKNADU	N AE K N AH D UW
NAKON	N AE K AH N
NAKRATKO	N AE K R AE T OW
NAKRCAN	N AE K R K AH N
NALAZE	N AH L EY Z
NALETU	N AE L AH T UW
NALO`IO	N AE L OW AY OW
NAM	N AE M
NAMET	N AE M AH T
NAMIJENJENA	N AE M AH JH EH N JH AH N AH
NAMJENJEN	N AE M JH EH N JH AH N
NAMJERAVA	N AE M JH EH R AH V AH
NAMJERI	N AE M JH AH R IY
NAMJE{TENIKA	N AE M JH T EH N AH K AH
NAOBLAKA	N EY AA B L AH K AH
NAOBLAKE	N EY AH B L EY K
NAOBLAKOM	N EY AA B L AH K AH M
NAOBLAKU	N EY AA B L AH K UW
NAOBLA~ENJE	N EY AA B L AH
NAPAD	N AE P AH D
NAPADA	N AE P AH D AH
NAPADE	N AE P EY D
NAPADIMA	N AH P AE D AH M AH
NAPADNUT	N AH P AE D N AH T
NAPADNUTA	N AE P AH D N Y UW T AH
NAPADU	N AE P AH D UW
NAPETOSTI	N AE P AH T AA S T IY
NAPISANO	N AH P IH S AH N OW
NAPISAO	N AH P IH S EY OW
NAPISATI	N AH P IH S AH T IY
NAPISE	N AH P AY Z
NAPLATITI	N AE P L AE T AH T IY
NAPLATNE	N AE P L AH T N
NAPLATNIM	N AE P L AE T N AH M
NAPLATNOM	N AE P L AE T N AH M
NAPLATNOME	N AE P L AH T N OW M
NAPLATU	N AE P L AH T UW
NAPOMENUO	N AE P AH M EH N Y UW OW
NAPORA	N AA P AO R AH
NAPRAVA	N AE P R AH V AH
NAPRAVITI	N AE P R AE V AH T IY
NAPREDAK	N AE P R AH D AH K
NAPULJU	N AH P UH L JH UW
NAPUSTI	N AH P AH S T IY
NARASLE	N AE R AH Z AH L
NARA{TAJA	N AE R AH T AE JH AH
NARA{TAJI	N AE R AH T AE JH IY
NAREDIO	N AH R IY D IY OW
NAROD	N AE R AH D
NARODA	N AE R AH D AH
NARODI	N AE R AH D IY
NARODNE	N AE R AH D N
NARODNOG	N AH R AA D N AH G
NARODNOM	N AH R AA D N AH M
NAS	N AE Z
NASELJA	N AH S EH L JH AH
NASELJE	N AE S AH L JH
NASELJIMA	N AH S EH L JH AH M AH
NASILJA	N AH S IH L JH AH
NASILJE	N AE S AH L JH
NASILJU	N AH S IH L JH UW
NASLJEDNIK	N AE Z L JH EH D N AH K
NASLJEDNIKA	N AE Z L JH EH D N AH K AH
NASLJEDNU	N AE Z L JH EH D N UW
NASLOVOM	N AE Z L AH V AH M
NASTALI	N AE S T AH L IY
NASTANAK	N AE S T AH N AH K
NASTAVI	N AE S T AH V IY
NASTAVITI	N AE S T AE V AH T IY
NASTAVKU	N AE S T AE V K UW
NASTAVLJA	N AE S T AE V L JH AH
NASTAVLJAMO	N AE S T AE V L JH AH M OW
NASTOJANJA	N AE S T AH JH AE N JH AH
NASTUPA	N AE S T Y UW P AH
NASTUPILI	N AE S T Y UW P AH L IY
NASTUPITI	N AE S T Y UW P AH T IY
NASTUPOM	N AE S T Y UW P AH M
NASTUPU	N AE S T Y UW P UW
NATJECANJE	N AE T JH AH K AH N JH
NATJECANJU	N AE T JH AH K AE N JH UW
NATJE~AJIMA	N AE T JH
NATO	N EY T OW
NATOU	N AE T UW
NATOVU	N AE T AH V UW
NATRAG	N AE T R AH G
NAVAROVALS	N AH V AE R AH V AH L Z
NAVELA	N AE V AH L AH
NAVESTI	N AH V EH S T IY
NAVE~ER	N EY V
NAVIKNULI	N AE V AH K N Y UW L IY
NAVODE^I	N AH V OW D AY
NAVODI	N AE V AH D IY
NAVODNIM	N AH V AA D N AH M
NAVODNO	N AH V AA D N OW
NAVODNOM	N AH V AA D N AH M
NAZIVAJU	N AH Z IH V AH JH UW
NAZNAKA	N AE Z N AH K AH
NAZO~AN	N AE Z OW
NAZO~NE	N AE Z OW
NAZO~NI	N AE Z OW
NAZO~NOSTI	N AE Z OW
NAZVAO	N AE Z EY OW
NAZVAV{I	N AE Z AH V AY
NA^I	N AA AY
NA{	N AA
NA{A	N AA AH
NA{E	N AA
NA{EGA	N AA EH G AH
NA{I	N AA AY
NA{IH	N AA IY
NA{IM	N AA IH M
NA{OJ	N AA AA JH
NA{TETIO	N AA T IY T IY OW
NA}ENA	N AA AH N AA
NA}ENO	N AA AH N OW
NA~ELA	N AA
NA~ELNIK	N AA
NA~IN	N AA
NA~INA	N AA
NA~INU	N AA
NE	N IY
NE(2)	N EY
NE#AD	N IY AE D
NEBOJ{E	N EH B AH JH
NEDALEKO	N AH D AE L AH K OW
NEDAVNO	N AH D AE V N OW
NEDAVNOG	N AH D AE V N AH G
NEDJELJU	N EH JH EH L JH UW
NEDJELOTVORNO	N EH JH AH L AH T V AO R N OW
NEGDJE	N EH G
NEGO	N EH G OW
NEIZRU~IVANJE	N IY Z R UW
NEIZRU~IVANJEM	N IY Z R UW
NEKA	N EH K AH
NEKADA{NJE	N EH K AH D AH N JH IY
NEKADA{NJEG	N EH K AH D AH N JH EH G
NEKADA{NJI	N EH K AH D AH N JH IY
NEKAKAV	N EH K AH K AH V
NEKA`NJAVANJE	N EH K AH N JH AE V AH N JH
NEKE	N IY K
NEKI	N EH K IY
NEKIM	N EH K AH M
NEKOLICINOM	N EH K AH L IH S AH N AH M
NEKOLIKO	N AH K AA L AH K OW
NEKORISNO	N EH K AH R IH Z N OW
NEKORISTAN	N EH K AH R IH S T AH N
NEMA	N EH M AH
NEMAJU	N EH M AH JH UW
NEMORALAN	N AH M AO R AH L AH N
NEOPOZIVU	N IY AH P AA Z AH V UW
NEOPRAVDANO	N IY OW P R AE V D AH N OW
NEOSNOVANI	N IY OW S N AA V AH N IY
NEOUBI~AJENO	N IY AH Y UW B IY
NEOVISNO	N IY AH V IH Z N OW
NEOVISNOST	N IY AH V IH Z N AH S T
NEOVISNOSTI	N IY AH V IH Z N AA S T IY
NEO~EKIVANOM	N IY OW
NEPALA	N EH P AH L AH
NEPALSKE	N EH P AH L S
NEPALU	N EH P AH L UW
NEPAR	N IY P AH R
NEPEDAGO{KE	N AH P EH D AH G OW K IY
NEPOSREDNOJ	N EH P AH Z R EH D N AH JH
NEPOVJERENJA	N AH P AA V AH R EH N JH AH
NEPOVOLJNE	N EH P AH V OW L JH N
NEPOVOLJNI	N EH P AH V OW L JH N IY
NEPOVOLJNIH	N EH P AH V OW L JH N IY
NEPOZNATA	N AH P AA Z N AH T AH
NEPRAVEDAN	N EH P R AE V AH D AH N
NEPRAVILNOSTI	N EH P R AH V AH L N AA S T IY
NEPRAVILNOSTIMA	N EH P R AH V AH L N AA S T AH M AH
NEPREKIDNO	N EH P R AH K IH D N OW
NEPRESTANCE	N EH P R EH S T AH N S
NEPRILAGO}ENE	N EH P R IH L AH G OW IH N
NEPRIMJERENO	N EH P R AH M JH EH R AH N OW
NEPRIPITOMLJENE	N EH P R AH P IH T AH M L JH IY N
NERASKIDIVE	N AH R AE S AH D AH V
NERAVNOPRAVAN	N EH R AH V N AA P R AH V AH N
NERETVA	N AH R EH T V AH
NERETVANSKA	N EH R AH T V AE N S AH
NERETVANSKOJ	N EH R AH T V AE N S AH JH
NESANICOM	N AH S AE N AH K AH M
NESLU`BENO	N EH Z L UW B AH N OW
NESRE^E	N EH Z AH R
NESRE^I	N EH Z AH R AY
NESRE^OM	N EH Z AH R AA M
NESTABILNA	N EH S T AH B IH L N AH
NESTABILNI	N EH S T AH B IH L N IY
NESTALE	N EH S T EY L
NESTALIH	N EH S T AH L IY
NESTALIMA	N EH S T AE L AH M AH
NESTALO	N EH S T AH L OW
NESTALU	N EH S T AH L UW
NESTAO	N EH S T EY OW
NESTA{ICE	N EH S T AH AY S
NESURADNJE	N EH S AH R AH D N JH
NETKO	N EH T OW
NEUGODNOSTI	N Y UW G AH D N AA S T IY
NEUPITNA	N Y UW P IH T N AH
NEUSPJELA	N Y UW S JH AH L AH
NEU~INKOVITA	N Y UW
NEVALJANIMA	N EH V AH L JH AE N AH M AH
NEVERIN	N EH V AH R AH N
NEVERINI	N AH V EH R AH N IY
NEVLADINE	N EH V L AH D AY N
NEVOLJI	N AH V OW L JH IY
NEZADOVOLJNI	N EH Z AH D AH V OW L JH N IY
NEZADOVOLJSTVO	N EH Z AH D AH V OW L JH S T V OW
NEZAKONITIM	N EH Z AH K AA N AH T AH M
NEZAKONITOM	N EH Z AH K AA N AH T AH M
NEZAVISNI	N EH Z AH V IH Z N IY
NEZAVISNOG	N EH Z AH V IH Z N AH G
NEZAVISNOGA	N EH Z AH V IH Z N AH G AH
NE^E	N IY
NE{TO	N IY T UW
NE~ASNOJ	N IY
NI	N IY
NIGERIJI	N AH JH EH R AH JH IY
NIJE	N AY JH
NIKAKAV	N IH K AH K AH V
NIKAKO	N IH K AH K OW
NIKAKVE	N IH K AH K V
NIKAKVIH	N AH K AE K V IY
NIKAKVIM	N AH K AE K V AH M
NIKOBARU	N AH K AA B AH R UW
NIKOLA	N IH K OW L AH
NINIJA	N IH N AH JH AH
NIP	N IH P
NISKA	N IH S AH
NISKIM	N IH S AH M
NISU	N IH S UW
NITI	N IH T IY
NIZ	N IH Z
NIZOZEMSKA	N IH Z AH Z EH M S AH
NIZOZEMSKE	N IH Z AH Z AH M S
NIZOZEMSKIM	N IH Z AH Z EH M S AH M
NIZOZEMSKOJ	N IH Z AH Z EH M S AH JH
NIZU	N IH Z UW
NJE	N JH IY
NJEGA	N JH EH G AH
NJEGOV	N JH EH G AH V
NJEGOVA	N JH EH G AH V AH
NJEGOVE	N JH AH G OW V
NJEGOVI	N JH EH G AH V IY
NJEGOVIM	N JH EH G AH V AH M
NJEGOVO	N JH EH G AH V OW
NJEGOVOM	N JH EH G AH V AH M
NJEGOVU	N JH EH G AH V UW
NJEMA~KA	N JH EH M AH
NJEMA~KI	N JH EH M AH
NJEMA~KIH	N JH EH M AH
NJEMA~KIM	N JH EH M AH
NJEMA~KOME	N JH EH M AH
NJEMCE	N JH EH M S
NJEMICOM	N JH EH M AH K AH M
NJEMU	N JH EH M UW
NJEZIN	N JH EH Z AH N
NJEZINI	N JH EH Z AH N IY
NJEZINIH	N JH EH Z AH N IY
NJEZINO	N JH EH Z AH N OW
NJEZINOJ	N JH EH Z AH N AH JH
NJIH	N JH IY
NJIHOV	N JH IH HH AH V
NJIHOVA	N JH IH HH AH V AH
NJIHOVI	N JH IH HH AH V IY
NJIHOVIH	N JH IH HH AH V IY
NJIHOVIM	N JH IH HH AH V AH M
NJIHOVO	N JH IH HH AH V OW
NJIHOVU	N JH IH HH AH V UW
NJIMA	N JH IH M AH
NJOJ	N JH AA JH
NJU	N JH UW
NJUJORKU	N JH UW JH AO R K UW
NO	N OW
NOBILA	N AA B AH L AH
NOBILO	N AA B AH L OW
NOGOMETA{A	N AH G AA M AH T AH AH
NORDIJSKIH	N AO R D IH JH S K IY
NORMALNIM	N AO R M AE L N AH M
NORVE{KA	N AO R V K AA
NORVE{KIM	N AO R V K IH M
NOSA~	N OW S AH
NOSILE	N OW Z AH L
NOVA	N OW V AH
NOVAC	N AA V AH K
NOVCA	N AA V K AH
NOVCU	N AA V K UW
NOVE	N OW V
NOVI	N OW V IY
NOVI(2)	N OW V AY
NOVIH	N AA V IY
NOVIM	N AA V AH M
NOVINAR	N AA V AH N AH R
NOVINARA	N AH V IH N AH R AH
NOVINARE	N AA V AH N AH R
NOVINARIMA	N AA V AH N AE R AH M AH
NOVINARKE	N AA V AH N AH R K
NOVINARSTVU	N AA V AH N AA R S T V UW
NOVINSKA	N AH V IH N S AH
NOVINSKI	N AH V IH N S IY
NOVINSTVO	N AH V IH N S T V OW
NOVO	N OW V OW
NOVOG	N AA V AH G
NOVOGA	N AA V AH G AH
NOVOGODI{NJA	N AH V AA G AH D IY N JH AA
NOVOGODI{NJE	N AH V AA G AH D IY N JH IY
NOVOGODI{NJEG	N AH V AA G AH D IY N JH EH G
NOVOGODI{NJOJ	N AH V AA G AH D IY N JH AA JH
NOVOJ	N AA V AH JH
NOVOM	N AA V AH M
NOVOOSNOVANO	N AA V UW Z N AA V AH N OW
NOVOST	N AA V AH S T
NOVOSTI	N OW V AO S T IY
NOVU	N OW V UW
NOV~ANU	N AA V
NO^	N OW
NO^AS	N OW AE Z
NO^A{NJEM	N OW AH N JH EH M
NO^I	N OW AY
NO^U	N OW UW
NO{EN	N OW EH N
NULA	N Y UW L AH
NULTA	N AH L T AH
NU`AN	N UW AE N
O	OW
OBA	OW B AH
OBALAMA	AH B AE L AH M AH
OBALE	AH B EY L
OBALI	AA B AH L IY
OBALNA	AH B AE L N AH
OBALNOM	AH B AE L N AH M
OBALU	AA B AH L UW
OBASJAO	AH B AE Z EY OW
OBAVEZE	AA B AH V IY Z
OBAVIJESTI	AA B AH V AH JH EH S T IY
OBAVIJESTIO	AA B AH V AH JH EH S T IY OW
OBAVIT	AA B AH V AH T
OBAVJESNI	AA B AH V EH Z N IY
OBAVJE{TAJNE	AA B AH V T AE JH N
OBAVLJANJU	AA B AH V L JH AE N JH UW
OBAVLJENI	AH B AE V L JH AH N IY
OBE^ALA	OW B EY L AH
OBE^ANA	OW B AE N AH
OBE^AO	OW B EY OW
OBILJE`AVAJU	AA B AH L JH AE V AH JH UW
OBILJE`ENA	AA B AH L JH AH N AA
OBILJE`IO	AA B AH L JH AY OW
OBITELJ	AA B AH T AH L JH
OBITELJI	AA B AH T EH L JH IY
OBITELJSKOG	AA B AH T EH L JH S K AH G
OBI{AO	AA B IY EY OW
OBJASNIO	AA B AE Z N IY OW
OBJAVILA	AA B AE V AH L AH
OBJAVILE	AA B EY V AH L
OBJAVILI	AA B AE V AH L IY
OBJAVILO	AA B AE V AH L OW
OBJAVIO	AA B EY V IY OW
OBJAVITI	AA B AE V AH T IY
OBJAVLJEN	AA B AE V L JH AH N
OBJAVLJENA	AA B AE V L JH AH N AH
OBJAVLJENO	AA B AE V L JH AH N OW
OBJAVLJENOJ	AA B AE V L JH AH N AH JH
OBJAVLJENOM	AA B AE V L JH AH N AH M
OBJAVLJIVALI	AA B AH V L JH IH V AH L IY
OBJAVLJIVANJE	AA B AE V L JH AH V AH N JH
OBJAVLJIVANJEM	AA B AE V L JH AH V AE N JH AH M
OBJA{NJENJA	AA B AH N JH EH N JH AH
OBJE	AA B
OBJEKTIVNI	AA B AH K T IH V N IY
OBLACI	AA B L AH S IY
OBLAKA	AA B L AH K AH
OBLA~NIJE	AA B L AH
OBLA~NO	AA B L AH
OBLETI	AA B L AH T IY
OBLIK	AA B L AH K
OBLIKU	AA B L AH K UW
OBLJETNICA	AA B L JH EH T N AH K AH
OBLJETNICE	AA B L JH EH T N AH S
OBMANJIVAO	AA B M AH N JH IH V EY OW
OBNA{A	AA B N AH AH
OBNOVI	AA B N AH V IY
OBNOVU	AA B N AH V UW
OBRANE	AA B R EY N
OBRATITI	AA B R AE T AH T IY
OBRAZOVANIH	AA B R AH Z AA V AH N IY
OBRAZOVANJE	AA B R AE Z AH V AH N JH
OBRA}ENIM	AA B R AH AH N IH M
OBRED	AA B AH R D
OBUHVA^A	AA B AH V AH AH
OBUHVA^AO	AA B AH V AH EY OW
OBUHVA^ENIH	AA B AH V AH AH N IY
OBUHVA^ENO	AA B AH V AH AH N OW
OBU~ENI	AA B UW
OBVEZA	AA B AH Z AH
OBVEZUJU^A	AA B AH Z UW JH UW AH
OBZIRA	AA B Z AH R AH
OCEANU	OW S IY N UW
OCIJENILO	AA S AH JH EH N AH L OW
OCIJENIO	AA S AH JH IY N IY OW
OCJENJENO	AA K JH EH N JH AH N OW
OCJENJUJU	AA K JH AH N JH UW JH UW
OD	AA D
ODALI	AA D AH L IY
ODANE	AH D EY N
ODASLANOM	AH D AE Z L AH N AH M
ODAZVALI	AH D AE Z AH L IY
ODBACILI	AA D AE S AH L IY
ODBIJU	AA D AH JH UW
ODBILI	AA D AH L IY
ODBILO	AA D AH L OW
ODBIO	AA D IY OW
ODBOR	AA D AH R
ODBORA	AA D AH R AH
ODGAJATELJ	AA JH AE JH AH T AH L JH
ODGODI	AA JH AH D IY
ODGODIO	AA JH OW D IY OW
ODGOVARAJU^I	AA JH AH V AE R AH JH UW AY
ODGOVARATI	AA JH AH V AE R AH T IY
ODGOVOR	AA JH AH V AH R
ODGOVORAN	AA JH AA V AH R AH N
ODGOVORILO	AA JH AH V AO R AH L OW
ODGOVORIO	AA JH AH V AO R IY OW
ODGOVORNA	AA JH AH V AO R N AH
ODGOVORNI	AA JH AH V AO R N IY
ODGOVORNOSTI	AA JH AH V AH R N AA S T IY
ODGO}ENA	AA JH OW AH N AA
ODLAGALI{TE	AA D L AE G AH L IY T IY
ODLAGALI{TEM	AA D L AE G AH L IY T EH M
ODLAGALI{TU	AA D L AE G AH L IY T UW
ODLAGANJU	AA D L AH G AE N JH UW
ODLAZITI	AA D L AE Z AH T IY
ODLA`E	AA D L AH
ODLUKA	AA D L UW K AH
ODLUKAMA	AA D L UW K AH M AH
ODLUKE	AA D L UW K
ODLUKU	AA D L UW K UW
ODLU~ILE	AA D L UW
ODLU~IO	AA D L UW
ODLU~ITI	AA D L UW
ODLU~IVAT	AA D L UW
ODLU~IVATI	AA D L UW
ODLU~NO	AA D L UW
ODMAH	AA D M AH
ODNOS	AA D N AH Z
ODNOSA	AA D N AH S AH
ODNOSE	AA D N OW Z
ODNOSI	AA D N AH S IY
ODNOSIMA	AA D N AA S AH M AH
ODNOSITI	AA D N AA S AH T IY
ODNOSNO	AA D N AA Z N OW
ODNOSU	AA D N AH S UW
ODOBRAVAJU	AA D AH B R AE V AH JH UW
ODOBRENO	AH D AA B R AH N OW
ODOBRILA	AH D AA B R AH L AH
ODREDE	AA D R IY D
ODREDIO	AA D R IY D IY OW
ODREDITI	AA D R EH D AH T IY
ODREDI{TA	AA D R AH D IY T AA
ODREKLI	AA D R EH K L IY
ODRE}EN	AA D AH R EH N
ODRE}ENE	AA D AH R IH N
ODRE}ENIH	AA D AH R AH N IY
ODRE}ENJE	AA D AH R IH N JH IY
ODRE}UJE	AA D AH R Y UW JH IY
ODR`ALE	AA D R EY L
ODR`ANA	AA D R AE N AH
ODR`ANOG	AA D R AE N AH G
ODR`ANOJ	AA D R AE N AH JH
ODR`AO	AA D R EY OW
ODR`AT	AA D R AE T
ODR`ATI	AA D R AE T IY
ODR`AVANJA	AA D R AH V AE N JH AH
ODR`AVANJE	AA D R AE V AH N JH
ODUSTATI	AH D AH S T AH T IY
ODUZETI	AA D Y UW Z AH T IY
ODUZIMANJEM	AA D Y UW Z AH M AE N JH AH M
ODVJETNI{TVA	AA D EH T N IY T V AA
ODVJETNI{TVO	AA D EH T N IY T V OW
ODVJETNI{TVOM	AA D EH T N IY T V AA M
ODVOJENA	AA D AA JH AH N AH
ODVOJENIM	AA D AA JH AH N AH M
OESESA	OW EH S AH S AH
OGLASILA	AA G L AE S AH L AH
OGLASILE	AA G L EY Z AH L
OGLEDNI	AA G L EH D N IY
OGRADE	OW G ER EY D
OJA~AO	AA JH AH
OKI^EN	AA K IY EH N
OKLEVETAO	AA K L AH V EH T EY OW
OKO	AA K OW
OKOLICA	AH K AA L AH K AH
OKOLI{	AA K AH L IY
OKOLI{A	AA K AH L IY AH
OKOLNOSTI	AA K OW L N AA S T IY
OKRENUT	AA K R AH N AH T
OKRENUTI	AA K R AH N Y UW T IY
OKRETATI	AA K R EH T AH T IY
OKRUGU	AA K R UW G Y UW
OKUPILI	AA K Y UW P AH L IY
OKUPILO	AA K Y UW P AH L OW
OKUPIRANA	AA K Y AH P IH R AH N AH
OKUPLJENI	AH K AH P L JH AH N IY
OKUPLJENO	AH K AH P L JH AH N OW
OKVIR	AA K V AH R
OLAK{ALO	AA L AH K AE L OW
OLAK{ATI	AA L AH K AE T IY
OLAK{ICE	AA L AH K AY S
OLIMPIJADA	AA L AH M P IH JH AH D AH
OLIMPIJADI	AA L AH M P IH JH AH D IY
OLUJA	AH L UW JH AH
OLUJNA	AH L AH JH N AH
OLUJNIM	AH L AH JH N AH M
OLUJNO	AH L AH JH N OW
OLUJNOM	AH L AH JH N AH M
OLUJNU	AH L AH JH N UW
OLUJU	AH L UW JH UW
OMERBA{I^U	AH M AH R B AH AY UW
OMETAJU	AH M EH T AH JH UW
OMOGU^ILA	AH M AA G Y UW IH L AH
OMOGU^UJE	AH M AA G Y UW Y UW JH IY
OMOTANA	AH M AA T AH N AH
ON	AA N
ON(2)	AO N
ONA	AH N AA
ONE	W AH N
ONE(2)	HH W AH N
ONE~ISTILA	W AH N
ONE~I{^ENJA	W AH N
ONI	AA N IY
ONIMA	AA N AH M AH
ONO	OW N OW
ONOGA	AA N AH G AH
OPALI^	AA P AH L IY
OPASAN	AA P AH Z AH N
OPASNO	AH P AE Z N OW
OPASNOST	AH P AE Z N AH S T
OPASNOSTI	AA P AH Z N AA S T IY
OPERACIJI	AA P AH R AE S AH JH IY
OPERACIJU	AA P AH R AE S AH JH UW
OPERIRAN	AH P EH R AH R AH N
OPISUJE	AA P AH S UW JH
OPOJNIH	AH P AA JH N IY
OPOMENU	AH P AA M AH N UW
OPORAVLJA	AA P AH R AE V L JH AH
OPORBA	AH P AO R B AH
OPORBENI	AH P AO R B AH N IY
OPORBENIM	AH P AO R B AH N AH M
OPORBENOGA	AA P AH R B EH N AH G AH
OPOVRGAVA	AH P AA V R G AH V AH
OPRAVDAN	AA P R AE V D AH N
OPRAVDANJE	AA P R AE V D AH N JH
OPRAVDANJEM	AA P R AH V D AE N JH AH M
OPRAVDANOST	AA P R AE V D AH N AH S T
OPREMU	AA P R AH M UW
OPREZA	AA P R AH Z AH
OPROSTITE	AA P R AH S T AY T
OPSKRBNI	AA P S R B N IY
OPTIMIST	AA P T AH M IH S T
OPTU`BAMA	AA P T UW B AE M AH
OPTU`EN	AA P T UW EH N
OPTU`ENI	AA P T UW AH N IY
OPTU`ENICIMA	AA P T UW AH N IH S AH M AH
OPTU`ENIH	AA P T UW AH N IY
OPTU`ENIK	AA P T UW AH N IH K
OPTU`ENOGA	AA P T UW AH N AA G AH
OPTU`ILI	AA P T UW IH L IY
OPTU`NICU	AA P T UW N IH K UW
OPTU`UJE	AA P T UW Y UW JH IY
OPTU`UJU	AA P T UW Y UW JH UW
OP^E	AA P
OP^IH	AA P IY
OP^INE	AA P IH N
OP^INI	AA P AH N IY
OP^INSKIM	AA P IH N S K IH M
OP^INSKO	AA P IH N S OW
OP^INSKOGA	AA P IH N S AA G AH
OP^INSKOM	AA P IH N S AA M
ORAHOVICE	AH R AE HH AH V AH S
ORALNO	AH R AE L N OW
ORANJSKI	AH R AE N JH S K IY
ORANJSKOGA	AH R AE N JH S K AH G AH
OREBI^A	AO R AH B IY AH
ORGANIZACIJA	AO R G AH N AH Z AE S AH JH AH
ORGANIZACIJE	AO R G AH N IH Z AH S AY JH
ORGANIZACIJOM	AO R G AH N AH Z AE S AH JH AH M
ORGANIZACIJU	AO R G AH N AH Z AE S AH JH UW
ORGANIZATOR	AO R G AH N AY Z AH T ER
ORGANIZATORI	AO R G AH N AH Z AE T AH R IY
ORGANIZIRA	AO R G AH N IH Z AH R AH
ORGANIZIRALI	AO R G AH N AH Z IH R AH L IY
ORGANIZIRAN	AO R G AH N IH Z AH R AH N
ORGANIZIRANIH	AO R G AH N AH Z IH R AH N IY
ORGANIZIRANIMA	AO R G AE N AH Z AH R AE N AH M AH
ORGANIZIRAO	AO R G AH N AH Z IH R EY OW
ORGANIZIRAT	AO R G AH N IH Z AH R AH T
ORU`ANE	AO R UW EY N
ORU`ANIH	AO R UW AE N IY
ORU`JA	AO R UW JH AA
ORU`JE	AO R UW JH IY
ORU`JEM	AO R UW JH EH M
ORU`JU	AO R UW JH UW
OSAM	AA S AH M
OSAMA	OW S AA M AH
OSAMDESET	AH S AE M D AH S AH T
OSAMDESETAK	AA S AH M D EH S AH T AH K
OSAMNAEST	AH S AE M N EY AH S T
OSAMSTO	AH S AE M S T OW
OSIGURANA	AA S AH G Y UH R AH N AH
OSIGURANI	AA S AH G Y UH R AH N IY
OSIGURANJA	AH S IH G Y AH R AE N JH AH
OSIGURANJE	AH S IH G Y AH R AH N JH
OSIGURANJU	AH S IH G Y AH R AE N JH UW
OSIGURANU	AA S AH G Y UH R AH N UW
OSIGURATI	AA S AH G Y UH R AH T IY
OSIGURAVATI	AH S IH G Y AH R AE V AH T IY
OSIJEK	AA S AH JH AH K
OSIJEKU	AH S IH JH AH K UW
OSIM	AA S AH M
OSJETIO	AA Z IY T IY OW
OSJETLJIVE	AA Z EH T L JH AH V
OSJETLJIVI	AA Z EH T L JH AH V IY
OSJETNO	AA Z EH T N OW
OSJE^A	AA Z AH
OSJE^ATI	AA Z AE T IY
OSJE~KO	AA Z
OSLABJET	AA S L AE B JH EH T
OSLABJETI	AA Z L AE B AH T IY
OSLABLJENA	AA Z L AE B L JH AH N AH
OSLABLJENI	AA Z L AE B L JH AH N IY
OSLOBODITELJSKE	AA Z L AH B AA D AH T AH L JH S K
OSLOBO}ENJE	AA S L OW B OW IH N JH IY
OSMAN	AA S M AH N
OSME	AA Z M
OSMERO	AA Z M AH R OW
OSNA`ILO	AA Z N AH IH L OW
OSNIVA~KOJ	AA Z N AH V AH
OSNOVALE	AA Z N AH V EY L
OSNOVAN	AA Z N AH V AH N
OSNOVANA	AA Z N AA V AH N AH
OSNOVAT	AA Z N AH V AH T
OSNOVE	AA Z N OW V
OSNUJU	AA Z N Y UW JH UW
OSNUTKU	AA Z N AH T UW
OSOBA	AA S AH B AH
OSOBE	AH S OW B
OSOBITO	AH S AA B AH T OW
OSOBLJA	AH S AA B L JH AH
OSOBNA	AH S AA B N AH
OSOBNI	AH S AA B N IY
OSOBNIM	AH S AA B N AH M
OSOBNO	AH S AA B N OW
OSOBU	AA S AH B UW
OSPORAVA	AA S AO R AH V AH
OSTACI	AA S T AH S IY
OSTACIMA	AA S T AE S AH M AH
OSTAJE	AA S T EY JH
OSTALE	AA S T EY L
OSTALIH	AA S T AH L IY
OSTALIM	AA S T AH L AH M
OSTALOG	AA S T AH L AH G
OSTALOGA	AA S T AE L AH G AH
OSTANU	AA S T AH N UW
OSTAO	AA S T EY OW
OSTATAKA	AA S T AE T AH K AH
OSTATI	AA S T AH T IY
OSTAVCI	AA S T AE V S IY
OSTAVKOM	AA S T AE V K AH M
OSTAVKU	AA S T AE V K UW
OSTOJI^	AA S T AH JH IY
OSTVARENJE	AA S T V AH R AH N JH
OSTVARITI	AA S T V AE R AH T IY
OSTVARUJE	AA S T V AH R UW JH
OSUDILA	AH S UW D AH L AH
OSUDIO	AH S UW D IY OW
OSUMNJI~EN	AH S AH M N JH IY
OSUMNJI~ENIKA	AH S AH M N JH IY
OSU}EN	AA S UW EH N
OSU}ENO	AA S UW AH N OW
OSVOJILA	AA Z AA JH AH L AH
OSVOJILI	AA Z AA JH AH L IY
OSVOJIO	AA Z OW JH IY OW
OSVRNUO	AA Z R N Y UW OW
OSVR^E	AA Z R
OTETU	AA T AH T UW
OTKADA	AA T AH D AH
OTKAZA	AA T AH Z AH
OTKAZALA	AA T AE Z AH L AH
OTKAZANE	AA T AH Z EY N
OTKAZAO	AA T AE Z EY OW
OTKAZIMA	AA T AE Z AH M AH
OTKA`E	AA T AH
OTKRIO	AA T R IY OW
OTKUCAO	AA T Y UW K EY OW
OTKUCAVAO	AA T Y AH K AE V EY OW
OTOCI	AA T AH S IY
OTOCIMA	AH T AA S AH M AH
OTOK	AA T AH K
OTOKA	AA T AH K AH
OTOKE	AH T OW K
OTOKU	AA T AH K UW
OTO~AC	AA T OW
OTO~JE	AA T OW
OTO~NE	AA T OW
OTPAD	AA T AH D
OTPADA	AA T AH D AH
OTPISU	AA T AH S UW
OTPREMNINE	AA T R AH M N AY N
OTPUSTITI	AA T AH S T AH T IY
OTPUTOVALA	AA T Y AH T AA V AH L AH
OTPUTOVAO	AA T Y AH T AA V EY OW
OTRANTSKIM	AA T R AE N T S AH M
OTROVAN	AA T R AH V AH N
OTVARA	AA T V AH R AH
OTVORENA	AA T V AO R AH N AH
OTVORENO	AA T V AO R AH N OW
OTVORENOM	AA T V AO R AH N AH M
OTVORENOME	AA T V AO R AH N OW M
OTVORENOMU	AA T V AH R EH N AH M UW
OTVORITI	AA T V AO R AH T IY
OVA	OW V AH
OVAJ	AA V AH JH
OVE	OW V
OVIH	AA V IY
OVLASTI	AA V L AE S T IY
OVO	AA V OW
OVOG	AA V AH G
OVOGA	AA V AH G AH
OVOGODI{NJI	AH V AA G AH D IY N JH IY
OVOGODI{NJOJ	AH V AA G AH D IY N JH AA JH
OVOJ	AA V AH JH
OVU	AA V UW
OZBILJNO	AA Z IH L JH N OW
OZBILJNU	AA Z IH L JH N UW
OZLIJE}EN	AA Z L AY JH EH N
OZLIJE}ENO	AA Z L AY JH AH N OW
OZLJEDA	AA Z L JH AH D AH
OZNAKA	AA Z N AH K AH
OZNA~ITI	AA Z N AH
OZRA~JA	AA Z R AH
O`IVLJAVANJE	OW IH V L JH AH V AH N JH
O`UJAK	OW Y UW JH AH K
O`UJKU	OW AH JH K UW
O{TE^ENI	OW T IY AH N IY
O{TRIM	OW T R IH M
O{TRO	OW T R OW
O{TROVICA	OW T R AA V AH K AH
O{TROVICE	OW T R AA V AH S
O~AJNE	OW
O~EKIVANO	OW
O~EKUJE	OW
O~EKUJU	OW
O~EVID	OW
O~EVIDACA	OW
O~IJU	OW
O~ISTITI	OW
O~UVATI	OW
PA	P AA
PACIJENT	P AE S AH JH AH N T
PACIJENTA	P AE S AH JH EH N T AH
PACIJENTIMA	P AE S AH JH EH N T AH M AH
PADA	P AE D AH
PADOVI	P AE D AH V IY
PADU	P AE D UW
PAG	P AE G
PAGA	P AE G AH
PAK	P AE K
PAKAO	P AE K EY OW
PAKETI^	P AE K AH T IY
PALADINA	P AH L AE D AH N AH
PALA~I	P AE L AH
PALA~U	P AE L AH
PALESTINACA	P AE L AH S T IH N AH K AH
PALESTINCA	P AE L AH S T IH NG K AH
PALESTINCI	P AE L AH S T IH N S IY
PALESTINE	P AE L AH S T AY N
PALESTINSKA	P AE L AH S T IH N S AH
PALESTINSKE	P AH L EH S T AH N S
PALESTINSKI	P EY L AH S T IH N S K IY
PALESTINSKIH	P AE L AH S T IH N S IY
PALESTINSKIM	P EY L AH S T IH N S K IH M
PALESTINSKOG	P AE L AH S T IH N S AH G
PALESTINSKOGA	P AE L AH S T IH N S AH G AH
PALESTINSKOJ	P AE L AH S T IH N S AH JH
PAMET	P AE M AH T
PAMTE	P AE M T
PAMTIMO	P AE M T AH M OW
PAMTITI	P AE M T AH T IY
PAO	P AW
PAPA	P AA P AH
PAR	P AA R
PARA	P EH R AH
PARIZU	P AE R AH Z UW
PARI{KIM	P AE R IY K IH M
PARI{KOG	P AE R IY K AA G
PARLAMENT	P AA R L AH M EH N T
PARLAMENTA	P AA R L AH M EH N T AH
PARLAMENTARNI	P AA R L AH M AH N T AA R N IY
PARLAMENTARNIH	P AA R L AH M AH N T AA R N IY
PARLAMENTU	P AA R L AH M EH N T UW
PARTNERIMA	P AA R T N EH R AH M AH
PARTNERSTVO	P AA R T N AH R S T V OW
PASKO	P AA S K OW
PASTI	P AE S T IY
PATITI	P AE T AH T IY
PATNJE	P AE T N JH
PAUELA	P AO AH L AH
PAVAO	P AA V AW
PEDAGOGA	P AH D AE G AH G AH
PEDESET	P EH D AH S AH T
PEPEO	P IY P IY OW
PERADI	P AH R AE D IY
PERONJA	P AH R AA N JH AH
PET	P EH T
PETAK	P EH T AH K
PETE	P IY T
PETERO	P EH T AH R OW
PETI	P EH T IY
PETICIJU	P AH T IH S AH JH UW
PETNAEST	P EH T N EY AH S T
PETNAESTE	P EH T N IY S T
PETODNEVNE	P AH T AA D N AH V N
PETOGA	P EH T AH G AH
PETORICA	P AH T AO R AH K AH
PETRA	P EH T R AH
PETRINOVI^A	P EH T R IH N AH V IY AH
PETSTO	P EH T S T OW
PETU	P EH T UW
PE{ON	P IY AO N
PILANA	P IH L AH N AH
PILANE	P AH L EY N
PILOTE	P AH L OW T
PINO~ETA	P IH N OW
PIROTEHNIKE	P AH R AA T AH N AY K
PIROTEHNI~AR	P AH R AA T AH N IY
PISANJE	P IH S AH N JH
PISANJU	P AH S AE N JH UW
PISMIMA	P IH Z M AH M AH
PITANJA	P AH T AE N JH AH
PITANJE	P IH T AH N JH
PITANJIMA	P AH T AE N JH AH M AH
PITAO	P IH T EY OW
PITKE	P IH T
PI{E	P AY
PI{TOLJEM	P AY T OW L JH AH M
PJESME	JH EH Z M
PJESNI{TVA	JH EH Z N IY T V AA
PLAN	P L AE N
PLANA	P L AE N AH
PLANINE	P L AH N AY N
PLANIRA	P L AE N AH R AH
PLANIRALA	P L AH N IH R AH L AH
PLANIRANJA	P L AE N AH R AE N JH AH
PLANIRANOG	P L AH N IH R AH N AH G
PLANIRAO	P L AH N IH R EY OW
PLANOM	P L AE N AH M
PLANOVIMA	P L AH N AA V AH M AH
PLATIO	P L EY T IY OW
PLATITI	P L AE T AH T IY
PLA^A	P L AA AH
PLA^AJU	P L AA AE JH UW
PLA^ANJA	P L AA AE N JH AH
PLA^ANJE	P L AA AE N JH
PLA^ANJU	P L AA AE N JH UW
PLA^ATI	P L AA AE T IY
PLA^E	P L AA
PLEBISCITARNO	P L AH B IH S AH T AA R N OW
PLEJBOKS	P L EH JH AH K S
PLESOVI	P L EH S AH V IY
PLIMNI	P L IH M N IY
PLIMNIM	P L IH M N AH M
PLIMNOGA	P L IH M N AH G AH
PLIN	P L IH N
PLINA	P L IH N AH
PLITKA	P L IH T AH
PLITKO	P L IH T OW
PLITVICE	P L IH T V AH S
PLJUSAK	P L JH UW S AH K
PLJUSKA	P L JH AH S AH
PLJUSKOVA	P L JH AH S AH V AH
PLJUSKOVI	P L JH AH S AH V IY
PLJUSKOVIMA	P L JH AH S AA V AH M AH
PLOVE	P L OW V
PLOVI	P L AA V IY
PLOVIDBOM	P L AH V IH D AH M
PLOVILI	P L AA V AH L IY
PLOVIO	P L OW V IY OW
PLO~I	P L OW
PLUS	P L AH S
PLU^NIH	P L UW N IY
PO	P OW
POBILE	P OW B AH L
POBJEDA	P AA B AH D AH
POBJEGLI	P AA B EH G L IY
POBJE}UJE	P AA B Y UW JH IY
POBOLJ{ATI	P AH B OW L JH AE T IY
POBRATIMSTVA	P AA B R AH T IH M S T V AH
POBUNA	P AA B Y UW N AH
POBUNE	P AA B Y UW N
POBUNJENICI	P AA B AH N JH EH N AH S IY
POBUNJENIK	P AH B AH N JH AH N AH K
POBUNJENIKA	P AA B AH N JH EH N AH K AH
POC	P AA K
POD	P AA D
PODACI	P AA D AH S IY
PODACIMA	P AH D AE S AH M AH
PODATAKA	P AH D AE T AH K AH
PODATKE	P AA D AH T
PODBEV{E	P AA D AH V
PODBEV{EKA	P AA D AH V EH K AH
PODGORANA	P AA JH AO R AH N AH
PODGORE	P AA D G OW R
PODIGNULI	P AA D AH G N Y UW L IY
PODIGNUTA	P AA D AH G N Y UW T AH
PODMETNUTA	P AA D M AH T N Y UW T AH
PODNE	P AA D N
PODNESENA	P AA D N EH S AH N AH
PODNIJELO	P AA D N IH JH AH L OW
PODRAVKE	P AA D R AH V K
PODRAVSKA	P AA D R AE V S K AH
PODRAVSKE	P AA D R AH V S K
PODRHTAVALO	P AA D R T AE V AH L OW
PODRIJETLOM	P AA D R AH JH EH T L AH M
PODRUMU	P AA D R UW M UW
PODRU~JA	P AA D R UW
PODRU~JE	P AA D R UW
PODRU~JIMA	P AA D R UW
PODRU~JU	P AA D R UW
PODR`AO	P AA D R EY OW
PODSJETILI	P AA D S JH EH T AH L IY
PODSJETIO	P AA D S JH IY T IY OW
PODSJE^A	P AA D S JH AH
PODSJE^AMO	P AA D S JH AE M OW
PODTAJNIKA	P AA D T AE JH N AH K AH
PODUPIRATI	P AA D Y AH P IH R AH T IY
PODUPIRE	P AA D AH P AY ER
PODUPRLE	P AA D AH P R L
PODUPRO	P AH D AH P R OW
PODUZETNI{TVA	P AA D Y AH Z EH T N IY T V AA
PODUZE^A	P AA D Y UW Z AH
PODUZE^E	P AA D Y UW Z
PODUZE^U	P AA D Y UW Z UW
PODVO`NJAKA	P AA D OW N JH AE K AH
PODZEMNA	P AA D Z EH M N AH
PODZEMNE	P AA D Z AH M
PODZEMNOJ	P AA D Z EH M N AH JH
POE	P OW
POGINULA	P AA JH AH N Y UW L AH
POGINULE	P AA JH AH N Y UW L
POGINULIMA	P AA JH AH N Y UW L AH M AH
POGINULO	P AA JH AH N Y UW L OW
POGINUO	P AH JH IH N Y UW OW
POGLAVLJE	P AA G L AH V L JH
POGLEDOM	P OW G L
POGODILA	P AH G AA D AH L AH
POGODILI	P AH G AA D AH L IY
POGODILO	P AH G AA D AH L OW
POGODIO	P AH G OW D IY OW
POGODITI	P AH G AA D AH T IY
POGON	P AA G AH N
POGO}ENIM	P OW G OW AH N IH M
POGRE{KAMA	P OW G AH R K AE M AH
POGRE{KE	P OW G AH R K IY
POGRIJE{ILA	P AA G R AY JH IH L AH
POINT	P OY N T
POJAS	P AA JH AH Z
POJASA	P AA JH AH S AH
POJASNIO	P AH JH AE Z N IY OW
POJASNOG	P AH JH AE Z N AH G
POJASU	P AA JH AH S UW
POJAVI	P AA JH AH V IY
POJAVIO	P AH JH EY V IY OW
POJA~ALI	P OW JH AH
POJA~ALO	P OW JH AH
POJA~AN	P OW JH AH
POJA~ANA	P OW JH AH
POJA~ANU	P OW JH AH
POJA~AT	P OW JH AH
POJEDINIH	P AH JH EH D AH N IY
POJEDINIM	P AH JH EH D AH N AH M
POJEDINOSTI	P AA JH AH D AH N AA S T IY
POKAJANJEM	P AA K AH JH AE N JH AH M
POKAZALE	P AA K AH Z EY L
POKAZALI	P AH K AE Z AH L IY
POKAZALO	P AH K AE Z AH L OW
POKAZUJU	P AA K AH Z UW JH UW
POKA`U	P OW K AH UW
POKOJNOGA	P AH K AA JH N AH G AH
POKOLJA	P AH K OW L JH AH
POKOPANI	P AH K AA P AH N IY
POKRAJ	P AA K R AH JH
POKRAJINAMA	P AA K R AH JH IH N AH M AH
POKRAJINI	P AA K R AE JH AH N IY
POKRAJINSKE	P AA K R AH JH AH N S
POKRENE	P AA K R IY N
POKRENULI	P AA K R AH N Y UW L IY
POKRET	P AA K R AH T
POKRIVA~	P AA K R AH V AH
POKRI^E	P AA K R IY
POKROVITELJ	P AA K R AA V AH T AH L JH
POKU{AVAJU	P OW K UW AE V AH JH UW
POL	P AO L
POLA	P OW L AH
POLAKO	P AA L AH K OW
POLAZI	P AA L AH Z IY
POLICAJACA	P AA L AH K AE JH AH K AH
POLICAJCA	P AA L AH K AE JH K AH
POLICIJA	P AH L IH S AH JH AH
POLICIJE	P AA L AH S AY JH
POLICIJI	P AH L IH S AH JH IY
POLICIJSKA	P AA L AH S IH JH S K AH
POLICIJSKE	P AA L AH S AH JH S K
POLICIJU	P AH L IH S AH JH UW
POLITIKE	P AA L AH T AY K
POLITIKU	P AH L IH T AH K UW
POLITI~AREM	P AA L AH T IY
POLITI~ARI	P AA L AH T IY
POLITI~AROM	P AA L AH T IY
POLITI~KA	P AA L AH T IY
POLITI~KE	P AA L AH T IY
POLITI~KI	P AA L AH T IY
POLITI~KIM	P AA L AH T IY
POLJANE	P OW L JH EY N
POLJE	P OW L JH IY
POLOVICE	P OW L OW V AY S
POLOVICI	P AH L AA V AH S IY
POLO`AJ	P OW L OW AE JH
POLO`AJA	P OW L OW AE JH AH
POLUAUTOCESTI	P AH L UW W AH T AH S EH S T IY
POMAGATI	P AH M AE G AH T IY
POMAK	P AA M AH K
POMIRBI	P AH M AH R B IY
POMI~E	P OW M IY
POMOGLI	P AH M AA G L IY
POMOGNE	P AA M AH N
POMORSKOG	P AH M AO R S AH G
POMORSKOGA	P AH M AO R S AH G AH
POMO^	P OW M OW
POMO^I	P OW M OW AY
POMO^NI	P OW M OW N IY
PONAJPRIJE	P AA N AH JH P R AY JH
PONAVLJAM	P AH N AE V L JH AH M
PONA{ANJE	P OW N AH AE N JH
PONEDJELJAK	P AA N AH JH EH L JH AH K
PONEGDJE	P AA N AH G
PONOVILO	P AH N AA V AH L OW
PONOVITI	P AH N AA V AH T IY
PONOVLJENI	P AH N AA V L JH AH N IY
PONOVLJENIH	P AH N AA V L JH AH N IY
PONOVLJENIM	P AH N AA V L JH AH N AH M
PONOVLJENOM	P AH N AA V L JH AH N AH M
PONOVNI	P AH N AA V N IY
PONOVNO	P AH N AA V N OW
PONOVNOM	P AH N AA V N AH M
PONO^	P OW N OW
PONO^I	P OW N OW AY
PONO^NOJ	P OW N OW N AA JH
PONTE	P AA N T
PONUDA	P AA N Y UW D AH
PONUDILE	P AA N Y UW D AH L
PONUDIO	P AA N Y UW D IY OW
PONU}EN	P OW N UW EH N
POPISU	P AA P AH S UW
POPLAVLJENA	P AA P L AE V L JH AH N AH
POPULARNOST	P AA P Y AH L AA R N AH S T
POPUNJAVA	P AH P AH N JH AH V AH
POPUST	P AA P AH S T
POPUT	P AA P AH T
PORAST	P AO R AH S T
PORASTA	P AH R AE S T AH
PORAZIO	P AH R EY Z IY OW
POREME^AJ	P AH R IY M AE JH
POREME^AJEM	P AH R IY M AE JH AH M
POREZNE	P AO R AH Z N
PORUKE	P AH R UW K
PORUKOM	P AH R UW K AH M
PORUKU	P AH R UW K UW
PORU~ENO	P AO R UW
PORU~ILA	P AO R UW
PORU~IO	P AO R UW
POSADA	P OW S AA D AH
POSADE	P OW Z EY D
POSADU	P AA S AH D UW
POSEBAN	P OW Z B AE N
POSEBICE	P AA S AH B AH S
POSEBNA	P AH S EH B N AH
POSEBNO	P AH S EH B N OW
POSEBNOST	P AH S EH B N AH S T
POSJET	P AA Z AH T
POSJETA	P AA Z AH T AH
POSJETITELJA	P AA Z AH T AH T EH L JH AH
POSJETITELJE	P AA Z EH T AH T AH L JH
POSJETITI	P AA Z EH T AH T IY
POSJETU	P AA Z AH T UW
POSKUPE	P AA S Y UW P
POSKUPILE	P AA S Y UW P AH L
POSKUPLJENJA	P AA S AH P L JH EH N JH AH
POSKUPLJENJIMA	P AA S AH P L JH EH N JH AH M AH
POSLA	P AA Z L AH
POSLALA	P AA Z L AH L AH
POSLAO	P AA Z L EY OW
POSLAT	P AA Z L AH T
POSLATI	P AA Z L AH T IY
POSLIJE	P AA Z L AY JH
POSLIJEOPERATIVNA	P AA Z L AH JH IY AA P AH R AH T IH V N AH
POSLIJEPODNE	P AA Z L IH JH AH P AH D N
POSLIJEPODNEVA	P AA Z L AH JH AH P AA D N AH V AH
POSLIJERATNE	P AA Z L IH JH AH R AH T N
POSLJEDICE	P AA Z L JH AH D AH S
POSLJEDNJE	P AA Z L JH AH D N JH
POSLJEDNJEGA	P AA Z L JH EH D N JH AH G AH
POSLJEDNJIH	P AA Z L JH EH D N JH IY
POSLJEDNJIM	P AA Z L JH EH D N JH AH M
POSLODAVCEM	P AA Z L AH D AE V S AH M
POSLOVA	P AA Z L AH V AH
POSLOVNA	P AA Z L AA V N AH
POSLOVNE	P AA Z L AH V N
POSLOVNI	P AA Z L AA V N IY
POSLOVODSTVA	P AA Z L AH V AA D S T V AH
POSMRTNI	P AA Z M R T N IY
POSMRTNIH	P AA Z M R T N IY
POSMRTNIM	P AA Z M R T N AH M
POSREDNIKOM	P AA Z R EH D N AH K AH M
POSREDOVANJA	P AA Z R AH D AH V AE N JH AH
POSTAJA	P AA S T AH JH AH
POSTAJE	P AA S T EY JH
POSTAJI	P AA S T AH JH IY
POSTAJOM	P AA S T AH JH AH M
POSTAO	P AA S T EY OW
POSTAT	P AA S T AH T
POSTAVI	P AA S T AH V IY
POSTAVILI	P AA S T AE V AH L IY
POSTAVLJANJE	P AA S T AE V L JH AH N JH
POSTAVLJENO	P AA S T AE V L JH AH N OW
POSTIGLA	P AA S T IH G L AH
POSTIGLE	P AA S T AH G AH L
POSTIGLI	P AA S T IH G L IY
POSTIGNU	P AA S T IH G N UW
POSTIGNUT	P AA S T IH G N AH T
POSTIGNUTOM	P AA S T AH G N Y UW T AH M
POSTI^I	P AA S T IY AY
POSTI`E	P AA S T IY
POSTO	P AA S T OW
POSTOJALE	P AA S T AH JH EY L
POSTOJANJU	P AA S T AH JH AE N JH UW
POSTOJATI	P AA S T AA JH AH T IY
POSTOJE	P AA S T OW JH
POSTOJI	P AA S T AH JH IY
POSTOTAK	P AA S T AH T AH K
POSTROJBA	P AA S T R AA JH AH
POSTUPAK	P AA S T Y UW P AH K
POSTUPAN	P AA S T Y UW P AH N
POSTUPKE	P AA S T AH P
POSTUPNO	P AA S T AH P N OW
POSTUPNOM	P AA S T AH P N AH M
POSVE^ENE	P AA Z IH N
POSVUDA	P AA Z Y UW D AH
POTE{KO^A	P OW T K OW AH
POTE{KO^E	P OW T K OW
POTICAJ	P AA T AH K AH JH
POTICAJNO	P AA T AH K AE JH N OW
POTI~E	P OW T IY
POTJE~E	P AA T JH
POTKRAJ	P AA T R AH JH
POTPIS	P AA T AH S
POTPISALE	P AA T AH S EY L
POTPISALI	P AA T IH S AH L IY
POTPISAN	P AA T AH S AH N
POTPISAT	P AA T AH S AH T
POTPISIVANJEM	P AA T AH S AH V AE N JH AH M
POTPISNICIMA	P AA T AH Z N IH S AH M AH
POTPORU	P AA T AH R UW
POTPREDSJEDNICA	P AA T R AH D S JH EH D N AH K AH
POTPREDSJEDNIK	P AA T R AH D S JH EH D N AH K
POTPUNA	P AA T Y UW N AH
POTPUNO	P AA T Y UW N OW
POTREBA	P AA T R AH B AH
POTREP{TINA	P AA T R EH P T IH N AH
POTRES	P OW T AH R Z
POTRESA	P AA T R AH S AH
POTRESIMA	P AA T R EH S AH M AH
POTRESU	P AA T R AH S UW
POTRO{A~	P AA T R OW AH
POTRO{A~KE	P AA T R OW AH
POTRO{ILA	P AA T R OW IH L AH
POTRO{ITI	P AA T R OW IH T IY
POTVRDI	P AA T V R D IY
POTVRDILA	P AA T V R D AH L AH
POTVRDILI	P AA T V R D AH L IY
POTVRDILO	P AA T V R D AH L OW
POTVRDIO	P AA T V R D IY OW
POTVR}ENO	P AA T V R AH N OW
POTVR}UJU	P AA T V R Y UW JH UW
POUZDANJE	P AW Z D AH N JH
POVEZOM	P AA V AH Z AH M
POVEZUJE	P AA V AH Z UW JH
POVE^A	P OW V AH
POVE^ANJA	P OW V AE N JH AH
POVE^ANJE	P OW V AE N JH
POVE^ANO	P OW V AE N OW
POVE^AVA	P OW V AE V AH
POVIJESNIM	P AA V AH JH EH Z N AH M
POVIJESTI	P AA V AH JH EH S T IY
POVI{ENOG	P OW V IY AH N AA G
POVJERENIK	P AA V EH R AH N AH K
POVJERENIKA	P AA V AH R EH N AH K AH
POVJERENSTVA	P AA V AH R EH N S T V AH
POVJERENSTVO	P AA V AH R EH N S T V OW
POVJESNI~AR	P AA V EH Z N IY
POVLASTICU	P AA V L AE S T AH K UW
POVLA~ENJU	P AA V L AH
POVLA~I	P AA V L AH
POVODOM	P AA V AH
POVODU	P AA V AH D UW
POVOLJAN	P AH V OW L JH AH N
POVOLJNE	P AH V OW L JH N
POVOLJNI	P AH V OW L JH N IY
POVOLJNIJE	P AA V OW L JH N AY JH
POVOLJNO	P AH V OW L JH N OW
POVRATAK	P AA V R AH T AH K
POVRATKA	P AA V R AE T AH
POVRATNU	P AA V R AE T N UW
POVREDOM	P OW V R
POVREMENO	P AA V R EH M AH N OW
POVR{INA	P AA V R AH N AA
POZADINI	P AH Z AE D AH N IY
POZDRAVLJAJU^I	P AA Z D R AE V L JH AH JH UW AY
POZIV	P AA Z AH V
POZIVA	P AA Z AH V AH
POZIVAJU	P AH Z IH V AH JH UW
POZIVAJU^I	P AH Z IH V AH JH UW AY
POZIVIMA	P AH Z IH V AH M AH
POZNATA	P AA Z N AH T AH
POZNATI	P AA Z N AH T IY
POZNATO	P AA Z N AH T OW
POZVALA	P AA Z AH L AH
POZVALE	P AA Z EY L
POZVALI	P AA Z AH L IY
POZVAO	P AA Z EY OW
PO`AR	P OW AA R
PO`ARU	P OW AE R UW
PO{ALJU	P OW AE L JH UW
PO{TIVANJE	P OW T IH V AH N JH
PO{TOVANE	P OW T AH V EY N
PO{TOVANI	P OW T AA V AH N IY
PO{TOVANJA	P OW T AH V AE N JH AH
PO{TOVANJE	P OW T AA V AH N JH
PO~AST	P OW
PO~ASTI	P OW
PO~ELA	P OW
PO~ELI	P OW
PO~EO	P OW
PO~ETAK	P OW
PO~ETI	P OW
PO~ETKA	P OW
PO~ETKOM	P OW
PO~ETKU	P OW
PO~INIO	P OW
PO~INJE	P OW
PO~INJENOG	P OW
PO~NU	P OW
PRAGMATI~NO	P R AE G M AH T IY
PRAKSI	P R AE K S IY
PRAKTI~KI	P R AE K T IY
PRATE	P R EY T
PRATITI	P R AE T AH T IY
PRAVA	P R AE V AH
PRAVDE	P R AE V D
PRAVEDNA	P R AH V EH D N AH
PRAVEDNE	P R AE V AH D N
PRAVEDNI	P R AH V EH D N IY
PRAVILA	P R AE V AH L AH
PRAVNI	P R AE V N IY
PRAVO	P R AE V OW
PRAVOG	P R AE V AH G
PRAVOSLAVNE	P R AH V AA Z L AH V N
PRAVOSU}A	P R AE V AH S UW AH
PRAZNI	P R AE Z N IY
PRAZNIKA	P R AE Z N AH K AH
PRAZNIKE	P R AE Z N AY K
PREBRODILA	P R IY B R AA D AH L AH
PREBROJAVA	P R IY B R AA JH AH V AH
PREBROJAVANJE	P R IY B R AA JH AH V AH N JH
PREBRZE	P R IY B R Z
PRED	P R EH D
PREDALI	P R IY D AE L IY
PREDAO	P R IY D EY OW
PREDATI	P R IY D AE T IY
PREDBACUJE	P R IY D AE K Y UW JH
PREDBLAGDANSKO	P R IY D L AE G D AE N S OW
PREDGRA}A	P R IY JH R AA AH
PREDGRA}IMA	P R IY JH R AA AH M AA
PREDIZBORNI	P R IY D IH Z AO R N IY
PREDIZBORNOJ	P R IY D IH Z AO R N AH JH
PREDIZBORNU	P R IY D IH Z AO R N UW
PREDJELE	P R IY JH IY L
PREDJELIMA	P R IY JH EH L AH M AH
PREDLAGALI	P R IY D L AE G AH L IY
PREDLO`ILI	P R IY D L OW IH L IY
PREDLO`IT	P R IY D L OW IH T
PREDMETI	P R IY D M EH T IY
PREDNOSTI	P R IY D N AA S T IY
PREDNOVOGODI{NJE	P R IY D N AH V AA G AH D IY N JH IY
PREDSJEDA	P R IY D S JH EH D AH
PREDSJEDANJE	P R IY D S JH EH D AH N JH
PREDSJEDATELJ	P R IY D S JH EH D AH T AH L JH
PREDSJEDNICE	P R IY D S JH EH D N AH S
PREDSJEDNIK	P R IY D S JH EH D N AH K
PREDSJEDNIKA	P R IY D S JH EH D N AH K AH
PREDSJEDNIKOM	P R IY D S JH EH D N AH K AH M
PREDSJEDNIKOV	P R IY D S JH EH D N AH K AH V
PREDSJEDNIKOVU	P R IY D S JH EH D N IH K AH V UW
PREDSJEDNIKU	P R IY D S JH EH D N AH K UW
PREDSJEDNI{TVA	P R IY D S JH EH D N IY T V AA
PREDSJEDNI~KE	P R IY D S JH EH D N IY
PREDSJEDNI~KIH	P R IY D S JH EH D N IY
PREDSJEDNI~KIM	P R IY D S JH EH D N IY
PREDSTAVILI	P R IY D S T AE V AH L IY
PREDSTAVIO	P R IY D S T EY V IY OW
PREDSTAVITI	P R IY D S T AE V AH T IY
PREDSTAVKU	P R IY D S T AE V K UW
PREDSTAVLJA	P R IY D S T AE V L JH AH
PREDSTAVLJALI	P R IY D S T AE V L JH AH L IY
PREDSTAVLJANJE	P R IY D S T AE V L JH AH N JH
PREDSTAVLJEN	P R IY D S T AE V L JH AH N
PREDSTAVNICI	P R IY D S T AE V N AH S IY
PREDSTAVNIK	P R IY D S T AE V N AH K
PREDSTAVNIKE	P R IY D S T AE V N AY K
PREDSTAVNIKOM	P R IY D S T AE V N AH K AH M
PREDSTAVNI~KU	P R IY D S T AE V N IY
PREDVI}AJU	P R IY D IY AE JH UW
PREDVI}EN	P R IY D IY EH N
PREDVI}ENA	P R IY D IY AH N AA
PREDVI}ENE	P R IY D IY IH N
PREDVI}ENO	P R IY D IY AH N OW
PREDVODIO	P R IY D OW D IY OW
PREGLED	P R EH G AH L D
PREGLEDOM	P R IY G L
PREGOVORA	P R IY G AA V AH R AH
PREGOVORE	P R IY G AA V AH R
PREGOVORI	P R IY G AA V AH R IY
PREGOVORIMA	P R IY G AH V AO R AH M AH
PREHRANE	P R IY HH R EY N
PREIMENUJE	P R IY AH M AH N Y UW JH IY
PREISPITANE	P R IY IH S AH T EY N
PREKID	P R IY K IH D
PREKINU	P R IY K IH N UW
PREKINULA	P R IY K IH N Y UW L AH
PREKINULI	P R IY K IH N Y AH L IY
PREKINUT	P R IY K IH N AH T
PREKINUTIH	P R IY K IH N Y AH T IY
PREKJU~ER	P R IY K JH UW
PREKO	P R IY K OW
PREKRIVENA	P R IY K R IH V AH N AH
PREKR{AJ	P R EH K R AE JH
PREKR{AJE	P R EH K R EY JH
PREKR{ITELJI	P R EH K R AH T EH L JH IY
PRELILA	P R IY L IH L AH
PREMA	P R IY M AA
PREMDA	P R IY M D AA
PREMIJER	P R IY M AY JH AH R
PREMIJERA	P R IY M IH JH AH R AH
PREMIJEROM	P R IY M IH JH AH R AH M
PREMIJERU	P R IY M IH JH AH R UW
PREMJE{TA	P R IY M JH IY T AA
PREMJE{TANJA	P R IY M JH IY T AE N JH AH
PRENESEN	P R IY N Z AH N
PRENIJELI	P R IY N IH JH AH L IY
PRENOSE	P R IY N OW Z
PRENOSI	P R IY N OW S IY
PREOPASNO	P R IY AH P AE Z N OW
PREOSTALOM	P R IY AA S T AH L AH M
PREPISANI	P R IY P IH S AH N IY
PREPORU~UJE	P R IY P AO R UW
PREPOZNAJEMO	P R IY P AA Z N AE JH AH M OW
PREPREKA	P R IY P R AH K AA
PREPUNOM	P R IY P Y UW N AH M
PREPUSTIO	P R IY P AH S T IY OW
PRERASTAO	P R IY R AE S T EY OW
PRESTAJU	P R IY S T AE JH UW
PRESTALE	P R IY S T EY L
PRESTANAK	P R IY S T AE N AH K
PRESTAO	P R IY S T EY OW
PRESUDE	P R IY S UW D
PRESUDU	P R IY S UW D UW
PRETE`ITO	P R IY T IY IH T OW
PRETHODNIKA	P R IY TH AA D N AH K AH
PRETPLATA	P R IY T L AE T AH
PRETPLATE	P R EH T L EY T
PRETPLATOM	P R IY T L AE T AH M
PRETPLATU	P R IY T L AE T UW
PRETPOSTAVKOM	P R IY T AA S T AE V K AH M
PREUSMJERENA	P R IY AH Z M JH EH R AH N AH
PREVELIK	P R IY V EH L AH K
PREVENCIJI	P R IY V EH N S AH JH IY
PREVEZEN	P R IY V IY Z AH N
PREVEZENI	P R IY V EH Z AH N IY
PREVI{E	P R IY V IY
PREVLADAVAT	P R IY V L AE D AH V AH T
PREVLADAVATI	P R IY V L AH D AE V AH T IY
PREVOZILA	P R IY V AA Z AH L AH
PREVOZIO	P R IY V OW Z IY OW
PREZIMI	P R IY Z IH M IY
PRE`IVJELE	P AH R IH V IY L
PRE`IVJELI	P AH R IH V AH L IY
PRE{AO	P AH R EY OW
PRI	P R AY
PRI(2)	P R IY
PRIBLI`AVA	P R IH B L IY AE V AH
PRIBLI`AVANJA	P R IH B L IY AH V AE N JH AH
PRIBLI`ILO	P R IH B L IY IH L OW
PRIDRU`IO	P R IH D R UW AY OW
PRIDRU`IVANJU	P R IH D R UW AH V AE N JH UW
PRIGODNOJ	P R AH G AA D N AH JH
PRIGODOM	P R IH G AH
PRIGOVORA	P R AH G AA V AH R AH
PRIHOD	P R IH HH AH D
PRIHVATILA	P R AH V AE T AH L AH
PRIHVATIO	P R AH V EY T IY OW
PRIHVATITI	P R AH V AE T AH T IY
PRIHVATLJIVIJI	P R IH V AH T L JH IH V AH JH IY
PRIHVA^E	P R IH V AH
PRIJATELJA	P R IH JH AH T EH L JH AH
PRIJATELJE	P R IH JH AH T AH L JH
PRIJATELJEVANJE	P R IH JH AH T EH L JH AH V AH N JH
PRIJATELJIMA	P R IH JH AH T EH L JH AH M AH
PRIJAVA	P R IH JH AH V AH
PRIJAVLJENE	P R IH JH AH V L JH IY N
PRIJAVU	P R IH JH AH V UW
PRIJE	P R AY JH
PRIJEDLOG	P R AH JH EH D L AH G
PRIJEDLOGA	P R AH JH EH D L AH G AH
PRIJEDLOGE	P R IH JH AH D L OW JH
PRIJELAZA	P R AH JH EH L AH Z AH
PRIJELAZNE	P R IH JH AH L AH Z N
PRIJELAZNU	P R IH JH AH L AE Z N UW
PRIJELAZU	P R AH JH EH L AH Z UW
PRIJELOMA	P R AH JH EH L AH M AH
PRIJEMNOJ	P R AH JH EH M N AH JH
PRIJEPODNE	P R IH JH AH P AH D N
PRIJETE	P R AH JH IY T
PRIJETNJE	P R IH JH AH T N JH
PRIJETNJU	P R AH JH EH T N JH UW
PRIJEVREMENOG	P R IH JH AH V R EH M AH N AH G
PRIKAZALA	P R AH K AE Z AH L AH
PRIKAZATI	P R AH K AE Z AH T IY
PRIKLJU~ENJE	P R IH K L JH UW
PRIKLJU~ILA	P R IH K L JH UW
PRIKUPIO	P R IH K Y UW P IY OW
PRIKUPITI	P R IH K Y UW P AH T IY
PRIKUPLJAO	P R AH K AH P L JH EY OW
PRIKUPLJATI	P R AH K AH P L JH AH T IY
PRIKUPLJENO	P R AH K AH P L JH AH N OW
PRILAZE	P R AH L EY Z
PRILIKA	P R IH L AH K AH
PRILIKE	P R AY L AY K
PRILJEV	P R IH L JH AH V
PRILOGA	P R IH L AH G AH
PRIMANJE	P R IH M AH N JH
PRIMANJU	P R AH M AE N JH UW
PRIMARNE	P R IH M AH R N
PRIMILA	P R IH M AH L AH
PRIMIO	P R IH M IY OW
PRIMITI	P R IH M AH T IY
PRIMI~E	P R IH M IY
PRIMJENJIVAO	P R IH M JH AH N JH IH V EY OW
PRIMJENJIVATI	P R IH M JH AH N JH IH V AH T IY
PRIMJENJUJE	P R IH M JH AH N JH UW JH
PRIMJERENU	P R IH M JH EH R AH N UW
PRIMJERICE	P R IH M JH AH R AH S
PRIMLJEN	P R IH M L JH AH N
PRIMORJA	P R AH M AO R JH AH
PRIMORJU	P R AH M AO R JH UW
PRIMORSKOGORANSKE	P R IH M AH R S AA G AH R AH N S
PRIOP^ENJE	P R AY AH P IH N JH IY
PRIOP^ENJU	P R AY AH P IH N JH UW
PRIOP^ENO	P R AY AH P AH N OW
PRIOP^ILA	P R AY AH P IH L AH
PRIOP^ILO	P R AY AH P IH L OW
PRIOP^IO	P R AY AH P AY OW
PRIPADNI	P R AH P AE D N IY
PRIPADNIK	P R AH P AE D N AH K
PRIPADNIKA	P R AH P AE D N AH K AH
PRIPADNIKE	P R IH P AH D N AY K
PRIPADNIKU	P R AH P AE D N AH K UW
PRIPADNOST	P R AH P AE D N AH S T
PRIPAZITI	P R AH P AE Z AH T IY
PRIPO^ENJU	P R IH P OW IH N JH UW
PRIPREMA	P R IH P R AH M AH
PRIPREMAMA	P R IH P R EH M AH M AH
PRIPREME	P R IH P R IY M
PRIPREMU	P R IH P R AH M UW
PRIREDBE	P R IH R AH D
PRIREDBI	P R AH R EH D IY
PRIRE}ENO	P R AY R AH N OW
PRIRODE	P R AH R OW D
PRIRODNE	P R IH R AH D N
PRIRODNIH	P R AH R AA D N IY
PRIRODNOM	P R AH R AA D N AH M
PRISILJEN	P R AH S IH L JH AH N
PRISJETILI	P R IH Z EH T AH L IY
PRISJE^AJU^I	P R IH Z AE JH UW AY
PRISTALA	P R IH S T AH L AH
PRISTALO	P R IH S T AH L OW
PRISTAO	P R IH S T EY OW
PRISTATI	P R IH S T AH T IY
PRISTRANOST	P R IH S T R AH N AH S T
PRISTUP	P R IH S T AH P
PRISTUPA	P R IH S T Y UW P AH
PRISTUPNE	P R IH S T AH P N
PRISTUPNIH	P R IH S T AH P N IY
PRITISAK	P R IH T AH S AH K
PRITISKA	P R AH T IH S AH
PRITOM	P R IH T AH M
PRIVATNOJ	P R AH V AE T N AH JH
PRIVEDEN	P R IH V AH D AH N
PRIVELA	P R IH V AH L AH
PRIVESTI	P R AH V EH S T IY
PRIVREMENO	P R IH V R EH M AH N OW
PRIZNA	P R IH Z N AH
PRIZNAJU^I	P R IH Z N AH JH UW AY
PRIZNALA	P R IH Z N AH L AH
PRIZNANJE	P R IH Z N AH N JH
PRIZNAO	P R IH Z N EY OW
PRI~A	P R IY
PRI~AONICA	P R IY
PRI~UVNA	P R IY
PRKOMET	P R K AA M AH T
PRO	P R OW
PROBIJEN	P R OW B AY JH AH N
PROBLEM	P R AA B L AH M
PROBLEMA	P R OW B L EH M AH
PROBLEMI	P R OW B L EH M IY
PROBLEMU	P R OW B L EH M UW
PROCES	P R OW S AH Z
PROCESA	P R OW S EH S AH
PROCESIJA	P R OW S EH S AH JH AH
PROCESU	P R OW S EH S UW
PROCJENAMA	P R OW K JH EH N AH M AH
PROCJENJUJU	P R OW K JH EH N JH UW JH UW
PRODAJOM	P R OW D AE JH AH M
PRODUBLJAVATI	P R OW D AH B L JH AE V AH T IY
PRODULJENJU	P R OW D AH L JH EH N JH UW
PROFESIONALNOG	P R OW F IY S IY AH N AE L N AH G
PROFESOR	P R OW F IY Z AH R
PROFESORA	P R OW F EH S AH R AH
PROGLASILE	P R OW G L EY Z AH L
PROGLASIO	P R OW G L EY S IY OW
PROGLA{EN	P R OW G L AA EH N
PROGLA{ENJA	P R OW G L AA IH N JH AA
PROGNOZA	P R OW N OW Z AH
PROGNOZE	P R OW N OW Z
PROGRAM	P R OW G R AE M
PROGRAMA	P R OW G R AE M AH
PROGRAME	P R OW G R EY M
PROGRAMSKI	P R OW G R AE M S K IY
PROGRAMU	P R OW G R AE M UW
PROGRES	P R AA G AH R Z
PROIZVODA	P R OW IH Z AH D AH
PROIZVODIMA	P R OW IH Z AA D AH M AH
PROIZVODNJE	P R OW IH Z AH D N JH
PROIZVODNJOM	P R OW IH Z AA D N JH AH M
PROIZVODNJU	P R OW IH Z AA D N JH UW
PROJEKATA	P R OW JH EH K AH T AH
PROJEKT	P R OW JH EH K T
PROJEKTA	P R OW JH EH K T AH
PROJEKTOM	P R OW JH EH K T AH M
PROJEKTU	P R OW JH EH K T UW
PROKLETSTVO	P R OW K L EH T S T V OW
PROLASKA	P R OW L AE S AH
PROLAZ	P R OW L AE Z
PROLAZAK	P R OW L AE Z AH K
PROMAR	P R OW M AA R
PROMATRA~A	P R OW M AE T R AH
PROMATRA~I	P R OW M AE T R AH
PROMET	P R OW M EH T
PROMETNA	P R OW M EH T N AH
PROMETNE	P R OW M EH T N
PROMETNICI	P R OW M EH T N AH S IY
PROMETNIM	P R OW M EH T N AH M
PROMETNOJ	P R OW M EH T N AH JH
PROMETU	P R OW M EH T UW
PROMI#BU	P R OW M IY B UW
PROMICANJU	P R OW M AH K AE N JH UW
PROMICATI	P R OW M IH K AH T IY
PROMILA	P R OW M IH L AH
PROMJENE	P R OW M JH IY N
PROMJENJIVA	P R OW M JH EH N JH AH V AH
PROMJENJIVO	P R OW M JH EH N JH AH V OW
PROMJENJIVOM	P R OW M JH EH N JH AH V AH M
PROMJENJIVU	P R OW M JH EH N JH AH V UW
PROMJENLJIVA	P R OW M JH EH N L JH AH V AH
PROMJENLJIVO	P R OW M JH EH N L JH AH V OW
PROMJENOM	P R OW M JH EH N AH M
PRONA^I	P R OW N AA AY
PRONA}EN	P R OW N AA EH N
PRONA}ENI	P R OW N AA AH N IY
PROPAGANDA	P R AA P AH G AE N D AH
PROPISA	P R OW P IH S AH
PROPISANE	P R OW P AH S EY N
PROPUSTA	P R OW P AH S T AH
PROPUSTE	P R OW P AH S T
PROPU{TAJU	P R OW P UW T AE JH UW
PRORA~UN	P R OW R AA
PRORA~UNA	P R OW R AA
PRORA~UNSKOG	P R OW R AA
PROSINCA	P R OW S IH NG K AH
PROSJE~NO	P R OW S JH IY
PROSLAVA	P R OW Z L AA V AH
PROSLAVAMA	P R OW S L AE V AH M AH
PROSLAVE	P R OW S L EY V
PROSLAVILE	P R OW S L EY V AH L
PROSLAVIO	P R OW S L EY V IY OW
PROSLAVITI	P R OW S L AE V AH T IY
PROSLAVLJA	P R OW S L AE V L JH AH
PROSLAVLJEN	P R OW S L AE V L JH AH N
PROSTATE	P R AA S T EY T
PROSTORA	P R OW S T AO R AH
PROSTORE	P R OW S T OW R
PROSTORU	P R OW S T AO R UW
PROSTRANA	P R OW S T R AE N AH
PROSTRANO	P R OW S T R AE N OW
PROSVJEDA	P R OW S V JH EH D AH
PROSVJEDIMA	P R OW S V JH EH D AH M AH
PROSVJEDNICI	P R OW S V JH EH D N AH S IY
PROTEKLA	P R OW T EH K L AH
PROTEKLE	P R OW T EH K AH L
PROTEKLIH	P R OW T EH K L IY
PROTEKLOJ	P R OW T EH K L AH JH
PROTEKLOME	P R OW T EH K L OW M
PROTESTANATA	P R OW T EH S T AE N AH T AH
PROTESTANTSKU	P R OW T EH S T AE N T S UW
PROTE^I	P R OW T IY AY
PROTIV	P R OW T IH V
PROTIVI	P R OW T IH V IY
PROTIVIO	P R OW T IH V IY OW
PROTIVNICI	P R OW T IH V N AH S IY
PROTIVNIK	P R OW T IH V N AH K
PROTOK	P R OW T AA K
PROTUKANDIDATKINJA	P R OW T Y AH K AE N D AH D AH T IH N JH AH
PROTUOBAVJE{TAJNE	P R OW T Y UW AH B AH V T AE JH N
PROTUZAKONITA	P R OW T Y UW Z AH K AA N AH T AH
PROTUZAKONITIM	P R OW T Y UW Z AH K AA N AH T AH M
PROTUZRA~NE	P R OW T AH Z R AH
PROUZRO~ILA	P R OW AH Z R OW
PROVEDBA	P R OW V EH D AH
PROVEDBOM	P R OW V EH D AH M
PROVEDE	P R OW V IY D
PROVESTI	P R OW V EH S T IY
PROVJERAVA	P R OW V EH R AH V AH
PROVODE	P R OW V OW D
PROVOKACIJA	P R OW V AH K AE S AH JH AH
PROZAPADNJA~KI	P R OW Z AH P AE D N JH AH
PROZAPADNO	P R OW Z AH P AE D N OW
PROZAPADNOG	P R OW Z AH P AE D N AH G
PROZORA	P R OW Z AO R AH
PROZORIMA	P R OW Z AO R AH M AH
PRO{ETAO	P R OW EH T EY OW
PRO{IRENJE	P R OW IH R AH N JH
PRO{IRILE	P R OW IH R AH L
PRO{IRIT	P R OW IH R AH T
PRO{LA	P R OW L AA
PRO{LE	P R OW L IY
PRO{LI	P R OW L IY
PRO{LIM	P R OW L IH M
PRO{LOG	P R OW L AA G
PRO{LOST	P R OW L AO S T
PRO{LOTJEDNA	P R OW L AA T JH EH D N AH
PRO{LOTJEDNOGA	P R OW L AA T JH EH D N AH G AH
PRO~ITALA	P R OW
PRO~ITAO	P R OW
PRUGA	P R UW G AH
PRUZI	P R UW Z IY
PRU`A	P R UW AH
PRU`TI	P R UW T IY
PRVA	P R V AA
PRVE	P R V
PRVENSTVO	P R V EH N S T V OW
PRVI	P R V IY
PRVIH	P R V IY
PRVO	P R V OW
PRVOG	P R V AA G
PRVOGA	P R V AA G AH
PRVOJ	P R V AA JH
PRVOM	P R V AA M
PRVOSTOLNICE	P R V AA S T OW L N AH S
PRVOSTOLNICI	P R V AA S T OW L N AH S IY
PRVOTNE	P R V AA T N
PRVU	P R V UW
PSA	S AA
PTICA	T IH K AH
PTICE	T AY S
PTI~JA	T IY
PTI~JE	T IY
PTI~JOM	T IY
PUBLICIST	P AH B L IH S IH S T
PUBLICISTA	P AH B L AH S IH S T AH
PUCNJAVA	P AH K N JH AH V AH
PUHATI	P AH HH AH T IY
PULJIZ	P UH L JH AH Z
PUNIH	P Y UW N IY
PUNIM	P Y UW N AH M
PUNO	P Y UW N OW
PUNTA	P UH N T ER
PUT	P UH T
PUTA	P Y UW T AH
PUTEM	P Y UW T AH M
PUTEVE	P UH T IY V
PUTEVI	P Y UW T AH V IY
PUTIN	P UW T IH N
PUTINOVIM	P Y UW T IH N AH V AH M
PUTNICI	P AH T N AH S IY
PUTNIKA	P AH T N AH K AH
PUTNI~KIM	P AH T N IY
PUTOVNICU	P Y UW T AA V N AH K UW
PUTU	P Y UW T UW
PU`AR	P UW AA R
PU{ENJE	P UW IH N JH IY
PU{IO	P UW AY OW
RAB	R AE B
RABATU	R AE B AH T UW
RAD	R AE D
RADA	R AA D AH
RADE	R EY D
RADECKI	R AH D EH K IY
RADENCI	R AH D EH N S IY
RADI	R AA D IY
RADIJA	R AE D AH JH AH
RADIJSKE	R AE D AH JH S K
RADIJU	R AE D AH JH UW
RADIKALNA	R AE D AH K AE L N AH
RADIKALNIM	R AE D AH K AE L N AH M
RADIO	R EY D IY OW
RADIONICA	R EY D IY AA N AH K AH
RADIOTELEVIZIJI	R EY D IY AA T AH L AH V IH Z AH JH IY
RADITI	R AE D AH T IY
RADNI	R AE D N IY
RADNICIMA	R AE D N IH S AH M AH
RADNIKA	R AE D N AH K AH
RADNOG	R AE D N AH G
RADNOGA	R AE D N AH G AH
RADOM	R AE
RADOST	R AE D AH S T
RADOVI	R AE D AH V IY
RADU	R AA D UW
RADUJE	R AE D Y UW JH
RAFAHU	R AE F AH HH UW
RAJKO	R AA ZH K OW
RAKETA	R AE K AH T AH
RAKETE	R AH K IY T
RAKETNOM	R AH K EH T N AH M
RANIJE	R AH N AY JH
RANIJIH	R AE N AH JH IY
RANIJU	R AE N AH JH UW
RANJEN	R AE N JH AH N
RANJENA	R AE N JH AH N AH
RANJENO	R AE N JH AH N OW
RANKA	R AE NG K AH
RANO	R AE N OW
RANOJUTARNJIH	R AE N AH JH AH T AA R N JH IY
RASIM	R AE S AH M
RASIPA	R AE S AH P AH
RASKID	R AE S AH D
RASKRI`JU	R AE S R IY JH UW
RASPITAJU	R AE S IH T AH JH UW
RASPOLAGANJU	R AE S AH L AH G AE N JH UW
RASPOLO`ENE	R AE S AH L OW IH N
RASPOLO`ENJE	R AE S AH L OW IH N JH IY
RASPONA	R AE S AH N AH
RASPOREDILE	R AE S AH R IY D AH L
RASPORE}UJE	R AE S P OW R Y UW JH IY
RASPRAVA	R AE S R AH V AH
RASPRAVE	R AE S P R EY V
RASPRAVITI	R AE S R AE V AH T IY
RASPRAVLJA	R AE S R AE V L JH AH
RASPRODAJE	R AE S R AH D EY JH
RAST	R AE S T
RASTE	R EY S T
RAT	R AE T
RATA	R AE T AH
RATIFICIRALE	R AH T AH F IH S AH R EY L
RATKA	R AE T AH
RATKO	R AE T K OW
RATNE	R AE T N
RATNIH	R AE T N IY
RATNOG	R AE T N AH G
RATNU	R AE T N UW
RATOVA	R AE T OW V AH
RATOVI	R AE T AH V IY
RATU	R AA T UW
RAVNATELJ	R AE V N AH T AH L JH
RAVNATELJA	R AE V N AH T EH L JH AH
RAVNATELJICA	R AE V N AH T EH L JH AH K AH
RAZARANA	R AH Z AE R AH N AH
RAZASUTI	R AE Z AH S UW T IY
RAZBJESNIO	R AE Z EH Z N IY OW
RAZDOBLJA	R AE Z D AA B L JH AH
RAZDOBLJE	R AE Z D AH B L JH
RAZDOBLJIMA	R AE Z D AA B L JH AH M AH
RAZDRA`LJIVI	R AE Z D R AH L JH IH V IY
RAZGLEDAO	R AE Z L EH D EY OW
RAZGOVARA	R AE Z AA V AH R AH
RAZGOVARALA	R AE Z AH V AE R AH L AH
RAZGOVARALI	R AE Z AH V AE R AH L IY
RAZGOVARAO	R AE Z AH V AE R EY OW
RAZGOVARATI	R AE Z AH V AE R AH T IY
RAZGOVORA	R AE Z AA V AH R AH
RAZGOVORI	R AE Z AA V AH R IY
RAZGOVOROM	R AE Z AA V AH R AH M
RAZGOVORU	R AE Z AA V AH R UW
RAZINE	R AH Z AY N
RAZINI	R AE Z AH N IY
RAZLIKE	R AE Z L AY K
RAZLIKU	R AE Z L AH K UW
RAZLI~ITIH	R AE Z L IY
RAZLOG	R AE Z L AH G
RAZLOGA	R AE Z L AH G AH
RAZLOZI	R AE Z L AH Z IY
RAZMATRALI	R AE Z M AE T R AH L IY
RAZMINIRANO	R AE Z M AH N IH R AH N OW
RAZMINIRATI	R AE Z M AH N IH R AH T IY
RAZMINIRAVANJE	R AE Z M AH N IH R AH V AH N JH
RAZMINIRAVANJU	R AE Z M IH N AH R AH V AE N JH UW
RAZMJERNO	R AE Z M JH AH R N OW
RAZMJESTILA	R AE Z M JH EH S T AH L AH
RAZMJE{TENI	R AE Z M JH T EH N IY
RAZMOTRENO	R AE Z M AA T R AH N OW
RAZMOTRIT	R AE Z M AA T R AH T
RAZMOTRITI	R AE Z M AA T R AH T IY
RAZNIH	R AE Z N IY
RAZORENIH	R AH Z AO R AH N IY
RAZORENIMA	R AE Z AH R EH N AH M AH
RAZORIO	R AH Z AO R IY OW
RAZORNOG	R AH Z AO R N AH G
RAZORNOGA	R AH Z AO R N AH G AH
RAZOVI^	R AE Z AH V IY
RAZRIJE{I	R AE Z R AY JH AY
RAZRJE{ENJA	R AE Z R JH IH N JH AA
RAZRJE{ENJEM	R AE Z R JH IH N JH EH M
RAZUMIJE	R AE Z AH M AY JH
RAZUMIJEVANJA	R AH Z UW M AH JH AH V AE N JH AH
RAZVEDRAVANJE	R AE Z EH D R AH V AH N JH
RAZVEDRITI	R AE Z EH D R AH T IY
RAZVODNILA	R AE Z AA D N AH L AH
RAZVOJ	R AE Z AH JH
RAZVOJU	R AE Z AH JH UW
RA{~ISTITI	R AA
RA~AN	R AA
RA~UN	R AA
RA~UNALNIH	R AA
RE#EP	R EY EH P
REAGIRAJU^I	R IY AH JH IH R AH JH UW AY
REAKCIJA	R IY AE K S AH JH AH
REAKCIJU	R IY AE K S AH JH UW
REALIZACIJA	R IY AE L AH Z AE S AH JH AH
REDA	R EY D AH
REDARSTVENIKA	R AH D AA R S T V EH N AH K AH
REDATELJA	R AH D AH T EH L JH AH
REDER	R EH D ER
REDOVITIH	R AH D AA V AH T IY
REDOVITIM	R AH D AA V AH T AH M
REDOVITO	R AH D AA V AH T OW
REDU	R AH D UW
REFERENDUM	R EH F ER EH N D AH M
REFERENDUMIMA	R AH F EH R AH N D Y UW M AH M AH
REFERIRATI	R AH F AH R IH R AH T IY
REFORME	R AH F AO R M
REGIJI	R AH JH IH JH IY
REGIONALNIM	R AH JH AY AH N AE L N AH M
REGISTAR	R IY JH IH S T ER
REGISTRACIJSKIH	R AH JH IH S T R AH S IH JH S K IY
REGISTRACIJSKIM	R AH JH IH S T R AH S IH JH S K AH M
REGISTRIRANIH	R AH JH IH S T R IH R AH N IY
REGISTRU	R AH JH IH S T R UW
REGRES	R EH G AH R Z
REIZBORU	R IY IH Z AH R UW
REKAO	R AH K EY OW
REKLA	R IH K L AA
RENATE	R AH N AA T AH
REPREZENTACIJA	R IH P R AH Z EH N T AE S AH JH AH
REPREZENTACIJE	R IH P R AH Z EH N T AH S AY JH
REPUBLIKE	R IY P AH B L AY K
REPUBLI~KOGA	R AH P AH B L IY
REPUBLI~KOME	R AH P AH B L IY
RESTORANIMA	R IH S T AH R AE N AH M AH
REUMATI~ARA	R IY Y UW M AH T IY
REUMATI~ARI	R IY Y UW M AH T IY
REUMATI~ARIMA	R IY Y UW M AH T IY
REZERVATU	R AH Z AH R V AH T UW
REZULTATE	R AH Z AH L T EY T
RE^I	R EY AY
RE`IMA	R EY AH M AA
RE`IMU	R EY AH M UW
RE~ENO	R EY
RIHTEROVE	R IH T AH R OW V
RIHTERU	R IH T AH R UW
RIJECI	R IH JH AH S IY
RIJEKA	R IH JH AH K AH
RIJEKE	R AH JH IY K
RIJEKU	R IH JH AH K UW
RIJETKE	R IH JH AH T
RIJETKOST	R AH JH EH T AH S T
RIJE{ENI	R AY JH AH N IY
RIJE{IT	R AY JH IH T
RIJE~	R AY JH
RIJE~I	R AY JH
RIJE~IMA	R AY JH
RIJE~KOJ	R AY JH
RIKARDO	R AH K AA R D OW
RIM	R IH M
RIMU	R IH M UW
RJE{AVANJE	R JH IY AE V AH N JH
RJE{AVANJEM	R JH IY AH V AE N JH AH M
RJE{ENJA	R JH IY IH N JH AA
RJE{ENJEM	R JH IY IH N JH EH M
RODA	R OW D AH
RODI	R OW D IY
RODILE	R OW D AH L
RODITELJI	R AA D AH T EH L JH IY
ROGA~A	R OW G AH
ROJTER	R AA JH T AH R
ROK	R AA K
ROKA	R OW K AH
ROKU	R OW K UW
ROME	R OW M
RON~EVI^	R AA N
RON~EVI^A	R AA N
ROPA	R OW P AH
RO`I^A	R OW AY AH
RO}EN	R OW EH N
RO}ENA	R OW AH N AA
RO}ENOJ	R OW AH N AA JH
RUJNA	R AH JH N AH
RUJNU	R AH JH N UW
RUPEL	R UW P AH L
RUSA	R UW S AH
RUSIJA	R UW S AH JH AH
RUSKE	R AH S
RUSKI	R AH S IY
RUTINSKI	R AH T IH N S K IY
RU`INSKI	R UW IH N S K IY
RU`NIH	R UW N IY
RU{ENJE	R UW IH N JH IY
RU{EVINA	R UW EH V AH N AH
RU{EVINAMA	R UW AH V IH N AH M AH
RU{IO	R UW AY OW
S	EH S
SA	S AA
SABMI{N	S AE B M IY N
SABOR	S EY B AH R
SABORA	S AE B AH R AH
SABORSKI	S AH B AO R S IY
SAD	S AE D
SADA	S AA D AH
SADAMA	S AE D AH M AH
SADA{NJA	S AE D AH N JH AA
SADA{NJE	S AE D AH N JH IY
SADA{NJEG	S AE D AH N JH EH G
SADA{NJI	S AE D AH N JH IY
SADA{NJIH	S AE D AH N JH IY
SADA{NJIM	S AE D AH N JH IH M
SADR`AJNI	S AE D R AE JH N IY
SADR`AVA	S AE D R AE V AH
SAGLEDATI	S AE G L EH D AH T IY
SAJAM	S AE JH AH M
SAJDVEJS	S AE JH D AH JH Z
SALIZANA	S AH L IH Z AH N AH
SALI`AN	S AE L IY AE N
SALVATOREA	S AE L V AH T AO R IY AH
SAM	S AE M
SAMARI	S AE M AH R IY
SAMI	S AE M IY
SAMO	S AE M OW
SAMOM	S AE M AH M
SAMOSTALNE	S AH M AA S T AH L N
SAMOUBILA~KIM	S AH M AW B AH L AH
SAMOUBOJICA	S AE M AW B AA JH AH K AH
SAMOUPRAVE	S AE M UW P R EY V
SANACIJE	S AE N AH S AY JH
SANACIJU	S AH N AE S AH JH UW
SANADER	S EY N EY D ER
SANADERA	S AH N AE D AH R AH
SANADEROM	S AH N AE D AH R AH M
SANADERU	S AH N AE D AH R UW
SANDOLF	S AE N D OW L F
SANITETSKE	S AE N AH T AH T S
SANJA	S AE N JH AH
SANTORA	S AA N T AO R AH
SAPATENOM	S AH P AE T AH N AH M
SARAJEVA	S AH R AE JH AH V AH
SARAJEVU	S AH R AE JH AH V UW
SASTANAK	S AE S T AH N AH K
SASTANAKA	S AE S T AE N AH K AH
SASTANCIMA	S AE S T AE N S AH M AH
SASTANKA	S AE S T AE NG K AH
SASTANKU	S AE S T AE NG K UW
SASTAO	S AE S T EY OW
SASTAV	S AE S T AH V
SASTAVU	S AE S T AH V UW
SAT	S AE T
SATA	S AE T AH
SATI	S AE T IY
SAUDIJSKE	S AO D AH JH S K
SAUDIJSKOJ	S AH D IH JH S K AH JH
SAV	S AE V
SAVA	S AA V AH
SAVEZ	S AE V AH Z
SAVEZA	S AE V AH Z AH
SAVEZNIKE	S AE V AH Z N AY K
SAVEZNIM	S AH V EH Z N AH M
SAVEZNOJ	S AH V EH Z N AH JH
SAVEZU	S AE V AH Z UW
SAVI^	S AE V IY
SAVJETA	S AE V AH T AH
SAVJETOVANJA	S AE V AH T AH V AE N JH AH
SAVJETOVANJE	S AE V EH T AH V AH N JH
SAVJETUJU	S AE V AH T Y UW JH UW
SAVR{ENO	S AE V R AH N OW
SAZNALA	S AE Z N AH L AH
SAZVAN	S AE Z AH N
SAZVANA	S AE Z AH N AH
SAZVANOJ	S AE Z AH N AH JH
SCENARIJ	S EH N AH R AH JH
SE	S EY
SEBE	S IY B
SEDAM	S EH D AH M
SEDAMDESET	S AH D AE M D AH S AH T
SEDAMNAEST	S AH D AE M N EY AH S T
SEDAMSTO	S AH D AE M S T OW
SEDME	S EH D M
SEDMORICA	S EH D M AO R AH K AH
SEIZMOGRAFI	S AY Z M AA G R AH F IY
SEKSUALNO	S EH K S W EY L N OW
SEKUNDARNE	S AH K AH N D AH R N
SEKUNDI	S AH K AH N D IY
SELA	S EH L AH
SELICE	S IY L AH S
SENATORA	S AH N AE T AH R AH
SENJ	S EH N JH
SENKA	S EH NG K AH
SERA	S IH R AH
SERGEJ	S AH R JH AH JH
SERIJA	S EH R AH JH AH
SERIJE	S AH R AY JH
SESTARA	S EH S T AH R AH
SESVETA	S EH Z AH T AH
SEZONE	S AH Z OW N
SHVATIO	SH V EY T IY OW
SICILIJI	S AH S IH L AH JH IY
SIDE	S AY D
SIDNEJA	S IH D N AH JH AH
SIDNIJU	S IH D N AH JH UW
SIDOR	S IH D ER
SIDU	S IH D UW
SIGURAN	S IH G Y AH R AH N
SIGURNE	S IH G AH R N
SIGURNO	S AH G AH R N OW
SIGURNOSNE	S AH G AH R N AH Z N
SIGURNOSNIM	S IH G AH R N AA Z N AH M
SIGURNOST	S AH G AH R N AH S T
SIGURNOSTI	S IH G AH R N AA S T IY
SIJE~NJA	S AY JH
SIJE~NJE	S AY JH
SILIKAT	S IH L AH K AH T
SILOVITIH	S AH L AA V AH T IY
SILVESTROVO	S IH L V EH S T R AH V OW
SIMBOL	S IH M B AH L
SIMONOVI^	S AH M AA N AH V IY
SINA	S IH N AH
SINAGOGE	S IH N AH G OW JH
SINDIKALNA	S IH N D AH K AE L N AH
SINDIKALNE	S IH N D AH K AH L N
SINDIKALNOG	S IH N D AH K AE L N AH G
SINDIKAT	S IH N D AH K AH T
SINDIKATA	S IH N D IH K AH T AH
SINDIKATI	S IH N D IH K AH T IY
SINDIKATIMA	S IH N D AH K AE T AH M AH
SINDIKATU	S IH N D IH K AH T UW
SINO^	S IH N OW
SINO^NOJ	S IH N OW N AA JH
SIROMA{NIM	S IH R AH M AH N IH M
SIROVINU	S AH R AA V AH N UW
SISA~KO	S IH S AH
SITUACIJU	S IH T Y UW AE S AH JH UW
SJEDALA	S JH EH D AH L AH
SJEDINJENE	S JH EH D AH N JH IY N
SJEDINJENIH	S JH AH D IH N JH AH N IY
SJEDINJENIM	S JH AH D IH N JH AH N AH M
SJEDNICA	S JH EH D N AH K AH
SJEDNICE	S JH EH D N AH S
SJEDNICI	S JH EH D N AH S IY
SJENI	S JH EH N IY
SJETILO	S JH EH T AH L OW
SJEVER	S JH IY V AH R
SJEVERA	S JH EH V AH R AH
SJEVERNE	S JH EH V AH R N
SJEVERNI	S JH AH V AH R N IY
SJEVERNJAK	S JH AH V AH R N JH AH K
SJEVERNO	S JH AH V AH R N OW
SJEVERNOATLANTSKOM	S JH AH V AH R N OW T L AE N T S AH M
SJEVERNOG	S JH AH V AH R N AH G
SJEVERNOGA	S JH AH V AH R N AH G AH
SJEVERNOJ	S JH AH V AH R N AH JH
SJEVERNOM	S JH AH V AH R N AH M
SJEVERNOME	S JH EH V AH R N OW M
SJEVEROISTO~NI	S JH EH V AH R OY S T OW
SJEVEROISTO~NJAK	S JH EH V AH R OY S T OW
SJEVEROISTO~NOJ	S JH EH V AH R OY S T OW
SJEVEROZAPADA	S JH EH V AH R AH Z AE P AH D AH
SJEVEROZAPADNI	S JH AH V EH R AH Z AH P AE D N IY
SJEVEROZAPADNIM	S JH AH V EH R AH Z AH P AE D N AH M
SJEVEROZAPADNJAK	S JH AH V EH R AH Z AH P AE D N JH AH K
SJEVEROZAPADNOG	S JH AH V EH R AH Z AH P AE D N AH G
SJEVEROZAPADNOGA	S JH AH V EH R AH Z AH P AE D N AH G AH
SJEVEROZAPADNOM	S JH AH V EH R AH Z AH P AE D N AH M
SJEVERU	S JH EH V AH R UW
SKANDAL	S K AE N D AH L
SKANDALE	S K AE N D EY L
SKIJANJA	S K AH JH AE N JH AH
SKIJATI	S K IH JH AH T IY
SKLADU	S K L AE D UW
SKLISKO	S K L IH S OW
SKLOPU	S K L AA P UW
SKORA{NJIM	S K AO R AH N JH IH M
SKORIH	S K AO R IY
SKRBI	S K R B IY
SKRIVANJE	S K R IH V AH N JH
SKUPA	S K Y UW P AH
SKUPILI	S K Y UW P AH L IY
SKUPINA	S K Y UW P AH N AH
SKUPINE	S K Y UW P AY N
SKUPINOM	S K Y UW P AH N AH M
SKUPINU	S K Y UW P AH N UW
SKUPIO	S K Y UW P IY OW
SKUPLJA	S K AH P L JH AH
SKUPLJENO	S K AH P L JH AH N OW
SKUPOCJENE	S K Y UW P AH K JH IY N
SKUPOCJENU	S K Y UW P AA K JH AH N UW
SKUP{TINA	S K AH P T IH N AH
SKUP{TINAMA	S K AH P T IH N AH M AH
SKUP{TINE	S K AH P T AY N
SKUP{TINI	S K AH P T IH N IY
SKVERU	S K V EH R UW
SLAB	S L AE B
SLABA	S L AE B AH
SLABI	S L AE B IY
SLABIJE	S L AH B AY JH
SLABIJI	S L AE B AH JH IY
SLABIJU	S L AE B AH JH UW
SLABIM	S L AE B AH M
SLABITI	S L AE B AH T IY
SLABJETI	S L AE B AH T IY
SLABLJENJU	S L AE B L JH EH N JH UW
SLABO	S L AE B OW
SLABOM	S L AE B AH M
SLABOST	S L AE B AH S T
SLABU	S L AE B UW
SLALOMSKU	S L AH L AA M S UW
SLASTICA	S L AE S T AH K AH
SLAVAN	S L EY V AH N
SLAVE	S L EY V
SLAVEN	S L EY V AH N
SLAVNU	S L AE V N UW
SLAVONIJI	S L AH V AA N AH JH IY
SLAVONSKI	S L AH V AA N S IY
SLAVONSKOM	S L AH V AA N S AH M
SLA`U	S L AA UW
SLIJEDE	S L AH JH IY D
SLIJEDE^E	S L AH JH IY D
SLIJEDE^EG	S L AH JH IY D EH G
SLIJEDE^I	S L AH JH IY D AY
SLIJEDE^IH	S L AH JH IY D IY
SLIJEDE^IM	S L AH JH IY D IH M
SLIJEDILA	S L AH JH EH D AH L AH
SLIJEDILI	S L AH JH EH D AH L IY
SLIJETANJA	S L IH JH AH T AE N JH AH
SLIKE	S L AY K
SLI~NE	S L IY
SLJEDE^IH	S L JH IY D IY
SLJEMENU	S L JH EH M AH N UW
SLOBODE	S L AH B OW D
SLOBODNI	S L AH B AA D N IY
SLOVENIJE	S L AA V AH N AY JH
SLOVENSKI	S L AH V AH N S K IY
SLOVENSKIH	S L AH V EH N S IY
SLUNJ	S L AH N JH
SLUNJA	S L AH N JH AH
SLUNJU	S L AH N JH UW
SLU`BA	S L UW B AA
SLU`BAMA	S L UW B AE M AH
SLU`BE	S L UW B IY
SLU`BENA	S L UW B AH N AA
SLU`BENE	S L UW B AH N IY
SLU`BENI	S L UW B AH N IY
SLU`BENIH	S L UW B AH N IY
SLU`BENIKA	S L UW B AH N IH K AH
SLU`BENIM	S L UW B AH N IH M
SLU`BENO	S L UW B AH N OW
SLU`BENOM	S L UW B AH N AA M
SLU`BI	S L UW B IY
SLU`E^I	S L UW AY
SLU`IO	S L UW AY OW
SLU{ALI	S L UW AE L IY
SLU{ATE	S L UW EY T
SLU{ATELJI	S L UW AH T EH L JH IY
SLU{ATELJICE	S L UW AH T EH L JH AH S
SLU~AJ	S L UW
SLU~AJA	S L UW
SLU~AJU	S L UW
SMANJE	S M AE N JH
SMANJENA	S M AE N JH AH N AH
SMANJENE	S M AE N JH IY N
SMANJENJE	S M AE N JH AH N JH
SMANJENJEM	S M AE N JH EH N JH AH M
SMANJENJU	S M AE N JH EH N JH UW
SMANJIO	S M AE N JH IY OW
SMATRA	S M AE T R AH
SMATRAJU	S M AE T R AH JH UW
SMATRAJU^I	S M AE T R AH JH UW AY
SMATRATI	S M AE T R AH T IY
SMETNJE	S M EH T N JH
SMIJE	S M AY JH
SMIJENILI	S M AH JH EH N AH L IY
SMIJENITI	S M AH JH EH N AH T IY
SMIRIVANJU	S M IH R AH V AE N JH UW
SMIRUJU	S M AH R UW JH UW
SMJENE	S M JH IY N
SMJERA	S M JH EH R AH
SMJERNICE	S M JH AH R N AH S
SMJERU	S M JH EH R UW
SMJE{TAJ	S M JH T AE JH
SMRT	EH S EH M AA R T
SMRTI	S M R T IY
SMRTONOSNU	S M R T AH N AA Z N UW
SMRZAVA	S M R Z AE V AH
SNA	S N AA
SNAGA	S N AE G AH
SNAGAMA	S N AE G AH M AH
SNAGE	S N EY JH
SNAGU	S N AE G Y UW
SNAZI	S N AE Z IY
SNA`NA	S N AA N AA
SNA`NOG	S N AA N AA G
SNIJEG	S N IH JH AH G
SNIJEGA	S N IH JH AH G AH
SNIJEGOM	S N IH JH AH G AH M
SNIMATELJA	S N IH M AH T EH L JH AH
SNIMCI	S N IH M S IY
SNIMKU	S N IH M K UW
SNJE`ANA	S N JH AE N AH
SNJE`NI	S N JH N IY
SNOM	S N AA M
SNOSI	S N AA S IY
SOBU	S OW B UW
SOCIJALNE	S AA S AH JH AH L N
SOCIJALNI	S AA S AH JH AE L N IY
SOCIJALNOG	S AA S AH JH AE L N AH G
SOCIJALNOM	S AA S AH JH AE L N AH M
SOCIOLOZI	S OW S IY AA L AH Z IY
SOKOVA	S AA K AH V AH
SOLANOM	S AA L AH N AH M
SOLIDARNOST	S AA L AH D AA R N AH S T
SOLIDARNOSTI	S AA L AH D AH R N AA S T IY
SOMALIJE	S AA M AH L AY JH
SOVJETSKOGA	S AA V EH T S AH G AH
SPARNO	S P AA R N OW
SPASILA~KE	S P AE S AH L AH
SPASILA~KI	S P AE S AH L AH
SPAVAONICE	S P AH V EY AH N AH S
SPA{AVANJA	S P AA AH V AE N JH AH
SPA{AVANJE	S P AA AE V AH N JH
SPECIJALISTI~KI	S P EH S AH JH AH L IH S T IY
SPIKERI	S P IH K AH R IY
SPLIT	S P L IH T
SPLITA	S P L IH T AH
SPLITSKE	S P L IH T S
SPLITSKO	S P L IH T S OW
SPLITSKOG	S P L IH T S AH G
SPLITSKOGA	S P L IH T S AH G AH
SPLITSKOJ	S P L IH T S AH JH
SPLITSKU	S P L IH T S UW
SPLITU	S P L IH T UW
SPOJIO	S P OW JH IY OW
SPOMEN	S P OW M AH N
SPOMENIK	S P AA M AH N AH K
SPOMINJE	S P AA M AH N JH
SPONZI	S P AA N Z IY
SPORAZUM	S P AO R AH Z AH M
SPORAZUMA	S P AO R AH Z UW M AH
SPORAZUMNOGA	S P AO R AH Z AH M N AH G AH
SPORAZUMOM	S P AO R AH Z UW M AH M
SPORAZUMU	S P AO R AH Z UW M UW
SPORE	S P AO R
SPORNI	S P AO R N IY
SPORNIM	S P AO R N AH M
SPORNOM	S P AO R N AH M
SPORO	S P AO R OW
SPORU	S P AO R UW
SPREMAN	S P R EH M AH N
SPREMNI	S P R EH M N IY
SPREMNOST	S P R EH M N AH S T
SPRIJE~ITI	S P R AY JH
SPUSTILA	S P AH S T AH L AH
SPUSTITI	S P AH S T AH T IY
SRAMA	S R AE M AH
SRBIJA	S R B IH JH AH
SRBIJANSKI	S R B AH JH AE N S IY
SRBIJE	S R B AY JH
SRBIJI	S R B IH JH IY
SRBIJU	S R B IH JH UW
SRCIMA	S R S IH M AH
SREBRENICI	S R EH B R EH N AH S IY
SREBRENI~KA	S R EH B R AH N IY
SREBRNU	S R EH B R N UW
SREDINE	S R AH D AY N
SREDINOM	S R EH D AH N AH M
SREDI{NJA	S R EH D IY N JH AA
SREDI{NJE	S R EH D IY N JH IY
SREDI{NJICE	S R EH D IY N JH AY S
SREDI{NJOJ	S R EH D IY N JH AA JH
SREDI{TEM	S R EH D IY T EH M
SREDNJE	S R EH D N JH
SREDNJEEUROPSKA	S R EH D N JH IY AH R AA P S AH
SREDNJEEUROPSKOJ	S R EH D N JH IY AH R AA P S AH JH
SREDNJEG	S R EH D N JH AH G
SREDNJEGA	S R EH D N JH AH G AH
SREDNJEM	S R EH D N JH AH M
SREDNJODALMATINSKE	S R EH D N JH AH D AE L M AH T AH N S
SREDNJOM	S R EH D N JH AH M
SREDOZEMLJEM	S R EH D AH Z EH M L JH AH M
SREDOZEMLJU	S R EH D AH Z EH M L JH UW
SREDSTVO	S R EH D S T V OW
SRETNA	S R EH T N AH
SRIJEDU	S R IH JH AH D UW
SRIJEMU	S R IH JH AH M UW
SRPNJU	S R P N JH UW
SRPSKE	S R P S
SRPSKOCRNOGORSKE	S R P S AA K R N AH G AH R S
SRPSKOGA	S R P S AA G AH
SRU{ILA	S R UW IH L AH
SRU{ILO	S R UW IH L OW
SRU{IO	S R UW AY OW
SR~ANE	S R
SR~ANI	S R
SR~ANIH	S R
STABILIZACIJI	S T AE B AH L AH Z AE S AH JH IY
STABILIZIRALA	S T AE B AH L AH Z IH R AH L AH
STABILNO	S T AH B IH L N OW
STABILNOST	S T AH B IH L N AH S T
STABILNOSTI	S T AE B AH L N AA S T IY
STABLA	S T AE B L AH
STAJALI{TA	S T AE JH AH L IY T AA
STAJALI{TE	S T AE JH AH L IY T IY
STAJALI{TIMA	S T AE JH AH L IY T IH M AH
STAJATI	S T AE JH AH T IY
STALNE	S T AE L N
STALNO	S T AE L N OW
STALNOG	S T AE L N AH G
STALNU	S T AE L N UW
STAMBENE	S T AE M B IY N
STANISLAV	S T AE N IH S L AA V
STANJE	S T AE N JH
STANJU	S T AE N JH UW
STANKE	S T AE NG K
STANOVA	S T AE N AH V AH
STANOVNICI	S T AH N AA V N AH S IY
STANOVNIKA	S T AH N AA V N AH K AH
STANOVNIKE	S T AE N AH V N AY K
STANOVNI{TVA	S T AH N AA V N IY T V AA
STARA	S T AE R AH
STARE	S T EH R
STARIH	S T AE R IY
STARIJE	S T AH R AY JH
STARIJIM	S T AE R AH JH AH M
STARIM	S T AE R AH M
STAROM	S T AE R AH M
STARTER	S T AA R T ER
STAVIO	S T EY V IY OW
STAVKA	S T AE V K AH
STAVLJA	S T AE V L JH AH
STE	S T IY
STEFANA	S T EH F AH N AH
STEFANI	S T EH F AH N IY
STEFANIJA	S T AH F AE N AH JH AH
STEGOVNI	S T AH G AA V N IY
STEJT	S T EH JH T
STE~AJ	S T IY
STE~AJA	S T IY
STIGAO	S T IH G EY OW
STIGLO	S T IH G L OW
STIJEGA	S T IH JH AH G AH
STIMULATIVNE	S T IH M Y UW L AH T AH V N
STIPE	S T AY P
STI^I	S T IY AY
STI`E	S T IY
STI`U	S T IY UW
STJEPAN	S T JH EH P AH N
STJEPANA	S T JH EH P AH N AH
STJEPANOM	S T JH EH P AH N AH M
STJEPANU	S T JH EH P AH N UW
STO	S T OW
STOGA	S T OW G AH
STOJI	S T AA JH IY
STOLICE	S T AA L AH S
STOLJE^A	S T OW L JH AH
STOMATOLO{KU	S T AH M AE T AH L OW K UW
STOPA	S T OW P AH
STOTINA	S T AA T AH N AH
STOTINE	S T AH T AY N
STOTINJAK	S T AH T IH N JH AH K
STOTINU	S T AA T AH N UW
STO`ER	S T OW EH R
STO`ERA	S T OW IH R AH
STO`ERU	S T OW EH R UW
STRADALA	S T R AE D AH L AH
STRADALE	S T R AH D EY L
STRADALIH	S T R AE D AH L IY
STRADALIM	S T R AE D AH L AH M
STRADALIMA	S T R AH D AE L AH M AH
STRADALO	S T R AE D AH L OW
STRADALOG	S T R AE D AH L AH G
STRADUNOM	S T R AE D Y UW N AH M
STRADUNU	S T R AE D Y UW N UW
STRAHU	S T R AE HH UW
STRAHUJE	S T R AE HH Y UW JH
STRAHUJU	S T R AE HH Y UW JH UW
STRANACA	S T R AE N AH K AH
STRANAKA	S T R AE N AH K AH
STRANA~KE	S T R AE N AH
STRANE	S T R EY N
STRANI	S T R AE N IY
STRANICE	S T R AE N AH S
STRANICI	S T R AE N AH S IY
STRANIM	S T R AE N AH M
STRANKA	S T R AE NG K AH
STRANKAMA	S T R AE NG K AH M AH
STRANKE	S T R AE NG K
STRATEGIJU	S T R AH T EH JH AH JH UW
STRATE{KI	S T R EY T K IY
STRATE{KIM	S T R EY T K IH M
STRAZBURU	S T R AE Z Y AH R UW
STRA`NJI	S T R AA N JH IY
STRA{NE	S T R AA N IY
STRELJIVA	S T R EH L JH AH V AH
STRIPOVA	S T R IH P OW V AH
STROGO	S T R AA G OW
STRUJE	S T R UW JH
STRUJU	S T R UW JH UW
STRUKOVNI	S T R UW K AA V N IY
STRUKOVNIH	S T R UW K AA V N IY
STRUKTURE	S T R AH K T Y AH R
STRU~NA	S T R UW
STRU~NJACI	S T R UW
STRU~NJAKA	S T R UW
STRU~NO	S T R UW
STUBI~KIH	S T Y UW B IY
STUDENATA	S T Y UW D EH N AH T AH
STUDENOGA	S T Y UW D EH N AH G AH
STUDENOME	S T Y UW D AH N OW M
STUDENTA	S T Y UW D EH N T AH
STUDENTE	S T Y UW D AH N T
STUDENTIMA	S T Y UW D EH N T AH M AH
STUDIJAMA	S T Y UW D IH JH AH M AH
STUP	S T AH P
STUPNJA	S T AH P N JH AH
STUPNJEVA	S T AH P N JH AH V AH
STVAR	S T V AA R
STVARANJE	S T V AE R AH N JH
STVARANJU	S T V AH R AE N JH UW
STVARATI	S T V AE R AH T IY
STVARNU	S T V AA R N UW
SU	S UW
SUBOTU	S AH B AA T UW
SUBRENUM	S AH B R AH N AH M
SUCA	S UW K AH
SUCU	S UW K UW
SUD	S AH D
SUDA	S UW D AH
SUDAC	S UW D AH K
SUDACA	S UW D AH K AH
SUDANSKOJ	S UW D AE N S AH JH
SUDARIO	S UW D AE R IY OW
SUDARU	S UW D AH R UW
SUDA~KE	S UW D AH
SUDA~KO	S UW D AH
SUDA~KOG	S UW D AH
SUDBENOM	S AH D AH N AH M
SUDBINA	S AH D AH N AH
SUDE^I	S UW D AY
SUDIONIKE	S UW D IY AH N AY K
SUDJELOVALI	S AH JH AH L AA V AH L IY
SUDJELOVALO	S AH JH AH L AA V AH L OW
SUDJELOVANJE	S AH JH EH L AH V AH N JH
SUDJELOVATI	S AH JH AH L AA V AH T IY
SUDJELUJE	S AH JH AH L UW JH
SUDJELUJU	S AH JH AH L UW JH UW
SUDOM	S UW
SUDSKI	S AH D S K IY
SUDSKIH	S AH D S K IY
SUDU	S UW D UW
SUHO	S AH HH OW
SUKOBA	S UW K AH B AH
SUKOBI	S UW K AH B IY
SUKOBIMA	S UW K AA B AH M AH
SUKOBU	S UW K AH B UW
SULEJMAN	S UW L EH JH M AH N
SUMAGLICA	S UW M AE G L AH K AH
SUMAGLICE	S UW M AE G L AH S
SUMAGLICOM	S UW M AE G L AH K AH M
SUMARTINA	S UW M AA R T AH N AH
SUMATRE	S UW M AH T AH R
SUMNJA	S AH M N JH AH
SUMNJAJU	S AH M N JH AH JH UW
SUMNJE	S AH M N JH
SUMNJIVIH	S AH M N JH AH V IY
SUMNJU	S AH M N JH UW
SUN~ANA	S AH N
SUN~ANIH	S AH N
SUN~ANIM	S AH N
SUN~ANO	S AH N
SUOSJE^ANJE	S UW W AH Z AE N JH
SUO~EN	S UW W OW
SUO~ENA	S UW W OW
SUPARNI~KIH	S UW P AA R N IY
SUPETAR	S UW P AH T AH R
SUPETARSKOG	S UW P AH T AA R S AH G
SUPETRU	S UW P EH T R UW
SUPROTNOSTI	S AH P R AH T N AA S T IY
SUPRUGE	S AH P R UW JH
SUPRUZI	S AH P R AH Z IY
SUPUTNIK	S UW P AH T N AH K
SURADNJA	S AH R AE D N JH AH
SURADNJE	S UH R AH D N JH
SURADNJI	S AH R AE D N JH IY
SURADNJU	S AH R AE D N JH UW
SURA}IVALA	S UH R AH IH V AH L AH
SURA}IVAO	S UH R AH IH V EY OW
SURA}UJE	S UH R AH Y UW JH IY
SUSJED	S AH Z D
SUSJEDIMA	S AH Z EH D AH M AH
SUSNJE`ICA	S AH Z N JH IH K AH
SUSNJE`ICOM	S AH Z N JH IH K AH M
SUSRET	S AH Z R AH T
SUSRETOM	S AH Z R AH T AH M
SUSTAV	S AH S T AH V
SUSTAVA	S AH S T AH V AH
SUSTAVNO	S AH S T AE V N OW
SUSTAVOM	S AH S T AH V AH M
SUSTAVU	S AH S T AH V UW
SUTKINJE	S AH T AH N JH
SUTRA	S AH T R AH
SUTRA{NJEG	S AH T R AH N JH EH G
SUTRA{NJIH	S AH T R AH N JH IY
SUVERENE	S UW V AH R IY N
SUVERENOST	S UW V EH R AH N AH S T
SU^URAJ	S UW Y UH R AH JH
SU^UTI	S UW Y UW T IY
SU{MA	S UW M AA
SU}ENJE	S UW IH N JH IY
SU~ELITI	S UW
SU~ELJAVANJA	S UW
SU~ELJAVANJE	S UW
SVA	S V AA
SVAKA	S V AE K AH
SVAKE	S V EY K
SVAKODNEVNO	S V AE K AH D N EH V N OW
SVAKOG	S V AE K AH G
SVARAJ	S V AE R AH JH
SVE	S V IY
SVEGA	S V EH G AH
SVEMIRSKA	S V AH M AH R S AH
SVEMIRSKI	S V AH M AH R S IY
SVEMIRSKOJ	S V AH M AH R S AH JH
SVEMIRSKOM	S V AH M AH R S AH M
SVEMU	S V EH M UW
SVENK	S V EH NG K
SVEOP^EM	S V IY AH P EH M
SVETA	S V EH T AH
SVETE	S V IY T
SVETI	S V EH T IY
SVETIM	S V EH T AH M
SVETI{TA	S V EH T IY T AA
SVETOG	S V EH T AH G
SVETOGA	S V EH T AH G AH
SVEU~ILI{NOJ	S V Y UW
SVE^ENIK	S V IY AH N IH K
SVE~ANA	S V IY
SVE~ANI	S V IY
SVE~ANO	S V IY
SVE~ANOJ	S V IY
SVE~ANOSTI	S V IY
SVE~ANU	S V IY
SVI	S V IY
SVIBNJA	S V IH B N JH AH
SVIH	S V IY
SVIJET	S V IH JH AH T
SVIJETA	S V IH JH AH T AH
SVIJETU	S V IH JH AH T UW
SVILANOVI^A	S V AH L AE N AH V IY AH
SVIM	S V IH M
SVIMA	S V IH M AH
SVIRALI	S V IH R AH L IY
SVI}AO	S V IY EY OW
SVJETSKA	S V JH EH T S AH
SVJETSKE	S V JH EH T S
SVJETSKIH	S V JH EH T S IY
SVJETSKOG	S V JH EH T S AH G
SVJETSKOGA	S V JH EH T S AH G AH
SVJETSKOJ	S V JH EH T S AH JH
SVJETSKOM	S V JH EH T S AH M
SVJE`IJE	S V JH AY JH
SVOJE	S V OW JH
SVOJEG	S V AA JH AH G
SVOJEGA	S V AA JH AH G AH
SVOJEMU	S V AA JH AH M UW
SVOJIH	S V AA JH IY
SVOJIM	S V AA JH AH M
SVOJIMA	S V AA JH AH M AH
SVOJOJ	S V AA JH AH JH
SVOJU	S V AA JH UW
SVRGNUTOG	S V R G N Y UW T AH G
SVRHA	S V R AA
SVUDA	S V Y UW D AH
TA	T AA
TABLICAMA	T AE B L IH K AH M AH
TADA	T AA D AH
TADIJANOVI^	T AE D AH JH AE N AH V IY
TADI^A	T AE D IY AH
TAJ	T AA ZH
TAJANSTVENOJ	T AH JH AE N S T V AH N AH JH
TAJLAND	T AE JH L AH N D
TAJLANDA	T AE JH L AE N D AH
TAJLANDSKA	T AE JH L AE N D S K AH
TAJLANDU	T AE JH L AE N D UW
TAJMS	T AE JH M Z
TAJNA	T AE JH N AH
TAJNIK	T AE JH N AH K
TAJNIKA	T AE JH N AH K AH
TAJVANA	T AE JH AH N AH
TAJVANSKI	T AE JH AE N S IY
TAJVANU	T AE JH AH N UW
TAK	T AE K
TAKAV	T AE K AH V
TAKO	T AE K OW
TAKOZVANI	T AH K AA Z AH N IY
TAKO}ER	T AE K OW EH R
TAKSIMU	T AE K S AH M UW
TAKSISTI	T AE K S IH S T IY
TAKVE	T AE K V
TAKVI	T AE K V IY
TAKVIH	T AE K V IY
TAKVOG	T AE K V AH G
TALIJANA	T AH L IH JH AH N AH
TALIJANE	T AE L AH JH EY N
TALIJANSKA	T AE L AH JH AE N S AH
TALIJANSKE	T AE L AH JH AH N S
TALIJANSKI	T AE L AH JH AE N S IY
TALIJANSKIH	T AE L AH JH AE N S IY
TALIJANSKIM	T AE L AH JH AE N S AH M
TALIJANSKO	T AE L AH JH AE N S OW
TALIJANSKOG	T AE L AH JH AE N S AH G
TALIJANSKOME	T AH L IH JH AH N S OW M
TALIJANSKU	T AE L AH JH AE N S UW
TALINU	T AE L AH N UW
TAMO	T AE M OW
TAMO{NJA	T AE M OW N JH AA
TAMO{NJE	T AE M OW N JH IY
TAMO{NJI	T AE M OW N JH IY
TAMO{NJIH	T AE M OW N JH IY
TAMO{NJIM	T AE M OW N JH IH M
TANJA	T AE N JH AH
TANJUGA	T AE N JH UW G AH
TAOCA	T EY AH K AH
TARTU	T AA R T UW
TATJANA	T AE T Y AA N AA
TE	T IY
TEA	T IY
TEGOBA	T EH G AH B AH
TEGOBE	T AH G OW B
TEHATE	T EH EY T
TEHATEU	T AH HH EY T Y UW
TEHNI~ARA	T EH N IY
TEHNI~KE	T EH N IY
TEHNI~KOG	T EH N IY
TEHNOLO{KI	T EH N AH L OW K IY
TEK	T EH K
TEKST	T EH K S T
TEKSTU	T EH K S T UW
TELEFON	T EH L AH F AA N
TELEFONA	T AH L EH F AH N AH
TELEFONIJE	T AH L EH F AH N AY JH
TELEFONIRAJU	T EH L AH F AH N IH R AH JH UW
TELEFONSKI	T EH L AH F AA N S IY
TELEFONSKIH	T EH L AH F AA N S IY
TELEFONSKU	T EH L AH F AA N S UW
TELEKOMUNIKACIJAMA	T AH L AH K AH M Y UW N AH K AH S IH JH AH M AH
TELEVIZIJA	T EH L AH V IH Z AH JH AH
TELEVIZIJI	T EH L AH V IH Z AH JH IY
TELEVIZIJSKE	T AH L EH V AH Z AH JH S K
TEMA	T EH M AH
TEME	T IY M
TEMELJ	T EH M AH L JH
TEMELJE	T EH M AH L JH
TEMELJILA	T AH M EH L JH AH L AH
TEMELJILO	T AH M EH L JH AH L OW
TEMELJNO	T AH M EH L JH N OW
TEMELJU	T AH M EH L JH UW
TEMPERATURA	T EH M P AH R AE T Y AH R AH
TEMPERATURE	T EH M P R AH CH ER
TEMPERATURE(2)	T EH M P ER AH CH ER
TEMPERATUROM	T EH M P AH R AE T Y AH R AH M
TEORETSKI	T IY AH R EH T S IY
TEORIJE	T IY AH R AY JH
TERCIJARNE	T AH R S AH JH AH R N
TEREN	T IY R AH N
TERENU	T EH R AH N UW
TERETNI	T AH R EH T N IY
TEREZINO	T AH R EH Z AH N OW
TERITORIJALNE	T EH R AH T AO R AH JH AH L N
TERORISTI	T EH R AH R IH S T IY
TERORISTI~KE	T EH R AH R IH S T IY
TERORIZMA	T EH R AH R IH Z M AH
TEVE	T IY V
TE`INI	T IY AH N IY
TE{KE	T IY K IY
TE{KI	T IY K IY
TE{KO	T IY K OW
TE{KOJ	T IY K AA JH
TE{KOM	T IY K AA M
TE{KO^A	T IY K OW AH
TE~E	T IY
TI	T IY
TIH	T IY
TIHI^	T IH HH IY
TIHO	T IH HH OW
TIHOM	T IH HH AH M
TIHOMIRA	T AH HH AA M AH R AH
TIJEK	T IH JH AH K
TIJEKOM	T IH JH AH K AH M
TIJEKU	T IH JH AH K UW
TIJELA	T IH JH AH L AH
TIJELU	T IH JH AH L UW
TIM	T IH M
TIMA	T IH M AH
TIME	T AY M
TIMOVI	T IH M AH V IY
TIN	T IH N
TIPA	T IH P AH
TIRENSKOG	T AH R EH N S AH G
TISAK	T IH S AH K
TISKA	T IH S AH
TISKANO	T IH S AH N OW
TISKU	T IH S UW
TISU^A	T IH S UW AH
TISU^E	T IH S UW
TISU^ITE	T IH S UW AY T
TISU^U	T IH S UW UW
TIVTA	T IH V T AH
TJEDAN	T JH IY D AH N
TJEDANA	T JH EH D AH N AH
TJEDNA	T JH EH D N AH
TJEDNIK	T JH EH D N AH K
TJEDNIKA	T JH EH D N AH K AH
TJEDNIKU	T JH EH D N AH K UW
TLAKA	T L AE K AH
TLAKOM	T L AE K AH M
TLO	T L OW
TLU	T L UW
TMURNA	T M AH R N AH
TMURNO	T M AH R N OW
TO	T UW
TO(2)	T IH
TO(3)	T AH
TOG	T AA G
TOGA	T OW G AH
TOJ	T AA JH
TOKSI~AN	T AA K S IY
TOLERANCIJA	T AA L AH R AE N S AH JH AH
TOLERANCIJE	T AH L EH R AH N S AY JH
TOLIKO	T AA L AH K OW
TOLJ	T OW L JH
TOM	T AA M
TOMA{EK	T OW M AH EH K
TOME	T OW M
TOMISLAV	T AH M IH Z L AH V
TOMISLAVA	T OW M IY Z L AA V AH
TOMO	T OW M OW
TONE	T OW N
TONI	T OW N IY
TONIJA	T AA N AH JH AH
TONSKA	T AA N S AH
TOPLICA	T AA P L AH K AH
TOPLIJE	T AA P L AY JH
TOPLO	T AA P L OW
TOPOLA	T AA P AH L AH
TORINU	T AO R AH N UW
TO~KA	T UW
TO~KAMA	T UW
TO~NO	T UW
TRADICIONALNA	T R AH D IH S IY AH N AE L N AH
TRADICIONALNI	T R AH D IH S IY AH N AE L N IY
TRADICIONALNO	T R AH D IH S IY AH N AE L N OW
TRADICIONALNOG	T R AH D IH S IY AH N AE L N AH G
TRADICIONALNOM	T R AH D IH S IY AH N AE L N AH M
TRAFALGAR	T R AH F AE L G ER
TRAGA	T R AE G AH
TRAGEDIJE	T R AE JH AH D AY JH
TRAGI~NA	T R AE JH IY
TRAGI~NIH	T R AE JH IY
TRAJALA	T R AE JH AH L AH
TRAJAO	T R AE JH EY OW
TRAJATI	T R AE JH AH T IY
TRAJE	T R EY JH
TRAJEKATA	T R AH JH EH K AH T AH
TRAJEKT	T R AE JH AH K T
TRAJEKTA	T R AH JH EH K T AH
TRAJEKTI	T R AH JH EH K T IY
TRAJEKTNI	T R AH JH EH K T N IY
TRAJEKTNIM	T R AH JH EH K T N AH M
TRAJEKTNOJ	T R AH JH EH K T N AH JH
TRAJNO	T R AE JH N OW
TRAKA	T R AE K AH
TRAKOM	T R AE K AH M
TRAMONTANE	T R AE M AH N T EY N
TRAMVAJI	T R AE M V AH JH IY
TRANSPORTNI	T R AE N S AO R T N IY
TRANSPORTNOG	T R AE N S AO R T N AH G
TRANZICIJE	T R AE N Z AH S AY JH
TRANZICIJSKU	T R AE N Z AH S IH JH S K UW
TRAVNJU	T R AE V N JH UW
TRA`E	T R AA
TRA`ENIH	T R AA AH N IY
TRA`ENJU	T R AA IH N JH UW
TRA`IO	T R AA AY OW
TRA`ITI	T R AA IH T IY
TRA~NICE	T R AA
TRBULJAK	T R B UH L JH AH K
TREBA	T R EH B AH
TREBAJU	T R EH B AH JH UW
TREBALA	T R EH B AH L AH
TREBALI	T R EH B AH L IY
TREBALO	T R EH B AH L OW
TREBAO	T R EH B EY OW
TREBAT	T R EH B AH T
TRENUTA~NO	T R EH N Y UW T AH
TRENUTKU	T R AH N AH T UW
TRETINJAK	T R AH T IH N JH AH K
TRETIRA	T R EH T AH R AH
TRE^E	T AH R
TRE^EGA	T AH R EH G AH
TRE^INA	T AH R AH N AA
TRGOVIMA	T R G AA V AH M AH
TRGOVINA	T R G AA V AH N AH
TRGOVINI	T R G AA V AH N IY
TRGU	T R G Y UW
TRI	T R AY
TRIBJUN	T R IH B AH N
TRIDESET	T R IH D AH S AH T
TRIDESETOGODI{NJI	T R IH D AH S AH T AA G AH D IY N JH IY
TRINAEST	T R IH N EY AH S T
TRINAESTA	T R AH N IY S T AH
TRINAESTOGA	T R AH N IY S T AH G AH
TRIPALA	T R IH P AH L AH
TRIPALO	T R IH P AH L OW
TRIPUNA	T R IH P Y UW N AH
TRISTO	T R IH S T OW
TRODNEVNOG	T R AA D N EH V N AH G
TRODNEVNU	T R AA D N EH V N UW
TROGODI{NJA	T R AA G AH D IY N JH AA
TROJE	T R OW JH
TROJICA	T R AA JH AH K AH
TROJNOGA	T R AA JH N AH G AH
TROVANJE	T R AA V AH N JH
TRO{ENJU	T R OW IH N JH UW
TRO{KOVE	T R OW K OW V
TRO~LANE	T R OW
TRUDNICE	T R AH D N AH S
TRUPLO	T R AH P L OW
TR`I{TU	T R AY T UW
TU	T UW
TULUZ	T Y UW L AH Z
TUMA~ENJA	T Y UW M AH
TUMORA	T Y UW M AH R AH
TUNEL	T Y UW N AH L
TUNELA	T Y UW N AH L AH
TUNELU	T Y UW N AH L UW
TURING	T UH R IH NG
TURISTA	T Y AH R IH S T AH
TURISTI	T Y AH R IH S T IY
TURISTI~KA	T Y AH R IH S T IY
TURISTI~KE	T Y AH R IH S T IY
TURISTI~KOJ	T Y AH R IH S T IY
TURISTI~KOM	T Y AH R IH S T IY
TURIZMA	T Y AH R IH Z M AH
TURNEJE	T AH R N IY JH
TURSKA	T AH R S AH
TURSKI	T ER S K IY
TURSKOJ	T AH R S AH JH
TURSKOME	T AH R S OW M
TU`BE	T UW B IY
TU`ITELJ	T UW IH T AH L JH
TU`ITELJICA	T UW AH T EH L JH AH K AH
TU`NE	T UW N IY
TU`NIH	T UW N IY
TU}MAN	T UW M AE N
TU}MANA	T UW M AA N AH
TU}MANOVE	T UW M AH N OW V
TU}MANU	T UW M AE N UW
TVRDI	T V R D IY
TVRDNJAMA	T V R D N JH AE M AH
TVRDNJU	T V R D N JH UW
TVRTKA	T V R T AA
TVRTKAMA	T V R T AE M AH
TVRTKE	T V R T
TVRTKI	T V R T IY
TVRTKOM	T V R T AA M
U	Y UW
UBIJEN	Y UW B AY JH AH N
UBIJENI	Y UW B IH JH AH N IY
UBIJENO	Y UW B IH JH AH N OW
UBILA	Y UW B AH L AH
UBILI	Y UW B AH L IY
UBLA`AVANJU	AH B L AH AH V AE N JH UW
UBOJICA	Y UW B AA JH AH K AH
UBOJICE	Y UW B AH JH AH S
UBOJSTVA	Y UW B AA JH S T V AH
UBOJSTVO	Y UW B AA JH S T V OW
UBRZANIH	AH B R Z AH N IY
UBUDU^E	Y UW B Y UW D UW
UDALJENO	Y UW D AE L JH AH N OW
UDARE	Y UW D AH R
UDARI	Y UW D AH R IY
UDARILA	Y UW D AE R AH L AH
UDARIMA	Y UW D AE R AH M AH
UDARU	Y UW D AH R UW
UDBINA	AH D AH N AH
UDBOM	AH D AH M
UDOVICA	Y UW D AA V AH K AH
UDRUGA	AH D R UW G AH
UDRUGE	AH D R UW JH
UDVOSTRU~ILA	AH D AA S T R UW
UDVOSTRU~ITI	AH D AA S T R UW
UGLAVNOM	AH G L AE V N AH M
UGLED	AH G AH L D
UGLEDNIM	AH G L EH D N AH M
UGLEDU	AH G L AH D UW
UGOVARANJA	Y UW G AH V AH R AE N JH AH
UGOVOR	Y UW G OW V AH R
UGOVORA	Y UW G AA V AH R AH
UGOVORENIH	Y UW G AH V AO R AH N IY
UGOVORNI	Y UW G AH V AO R N IY
UGOVORU	Y UW G AA V AH R UW
UGO}AJ	Y UW G OW AE JH
UGRADNJE	AH G R AH D N JH
UGRIN	AH G R AH N
UGRO`AVAJU	AH G R OW AE V AH JH UW
UGRO`ENE	AH G R OW IH N
UGU{ILA	Y UW G Y UW IH L AH
UHITI	AH HH AH T IY
UHITILA	AH HH IH T AH L AH
UHITILE	AH HH AH T AH L
UHI^EN	AH HH IY EH N
UHI^ENJA	AH HH IY IH N JH AA
UJEDINILA	Y UW JH AH D IH N AH L AH
UJEDINJENI	Y UW JH AH D IH N JH AH N IY
UJEDINJENIH	Y UW JH AH D IH N JH AH N IY
UJEVI^	Y UW JH AH V IY
UJUTRO	Y UW JH AH T R OW
UKAZUJU	Y UW K AH Z UW JH UW
UKINE	Y UW K AY N
UKINULE	Y UW K AH N Y UW L
UKINUO	Y UW K IH N Y UW OW
UKINU^A	Y UW K AH N UW AH
UKLANJANJE	AH K L AE N JH AH N JH
UKLANJANJU	AH K L AH N JH AE N JH UW
UKLJU~UJU^I	AH K L JH UW
UKRAJINCI	AH K R AH JH IH N S IY
UKRAJINE	AH K R AH JH AY N
UKRAJINI	AH K R AE JH AH N IY
UKRCAJ	AH K R K AH JH
UKUPNIM	Y UW K AH P N AH M
UKUPNO	Y UW K AH P N OW
ULAGANJE	Y UW L AH G AH N JH
ULAGATI	Y UW L AE G AH T IY
ULASKU	Y UW L AE S UW
ULAZAK	Y UW L AH Z AH K
ULAZE	Y UW L EY Z
ULAZNICA	Y UW L AE Z N AH K AH
ULAZNICU	Y UW L AE Z N AH K UW
ULAZU	Y UW L AH Z UW
ULICAMA	Y UW L IH K AH M AH
ULICI	Y UW L AH S IY
ULICOM	Y UW L AH K AH M
ULIJEVA	Y UW L IH JH AH V AH
ULOGA	Y UW L AH G AH
ULOGE	Y UW L OW JH
ULOGU	Y UW L AA G Y UW
ULOZI	Y UW L AH Z IY
ULO`ILA	Y UW L OW IH L AH
UMIJE{ANOST	Y UW M AY JH AE N AH S T
UMIROVLJENI	Y UW M AH R AA V L JH AH N IY
UMIROVLJENJA	Y UW M AH R AH V L JH EH N JH AH
UMJEREN	AH M JH AH R AH N
UMJERENA	AH M JH EH R AH N AH
UMJERENE	AH M JH AH R IY N
UMJERENI	AH M JH EH R AH N IY
UMJERENIM	AH M JH EH R AH N AH M
UMJERENO	AH M JH EH R AH N OW
UMJERENOM	AH M JH EH R AH N AH M
UMJERENU	AH M JH EH R AH N UW
UMJESTO	AH M JH EH S T OW
UMJETNIH	AH M JH EH T N IY
UMJETNI~KA	AH M JH EH T N IY
UMJETNOSTI	AH M JH AH T N AA S T IY
UMRLO	AH M R L OW
UMRO	AH M R OW
UNA	UW N AH
UNATRAG	AH N AE T R AH G
UNICEFA	Y UW N AH S EH F AH
UNIJA	Y UW N AH JH AA
UNIJE	Y UW N AH JH
UNIJI	Y UW N AH JH IY
UNIJOM	Y UW N AH JH AA M
UNIJU	Y UW N AH JH UW
UNI{TEN	AH N IY T EH N
UNI{TENJE	AH N IY T EH N JH
UNI{TENO	AH N IY T EH N OW
UNO	AH N OW
UNO(2)	UW N OW
UNOS	UW N OW Z
UNUTARNJIH	AH N Y AH T AA R N JH IY
UNUTRA{NJOST	AH N AH T R AH N JH AA S T
UNUTRA{NJOSTI	AH N AH T R AH N JH AA S T IY
UOBI~AJENE	Y UW AH B IY
UOBI~AJENI	Y UW AH B IY
UOP^E	Y UW AH P
UO~I	Y UW OW
UPALI	Y UW P AH L IY
UPERENIM	Y UW P EH R AH N AH M
UPITAN	Y UW P AY T AH N
UPLATILA	AH P L AE T AH L AH
UPLATOM	AH P L AH T AH M
UPLETANJE	AH P L AH T AH N JH
UPLETENOST	AH P L EH T AH N AH S T
UPORABU	Y UW P AO R AH B UW
UPOTREBLJAVAJU	Y UW P AA T R AH B L JH AE V AH JH UW
UPOTRIJEBITI	Y UW P AA T R AH JH EH B AH T IY
UPOZORAVA	Y UW P AH Z AO R AH V AH
UPOZORAVAJU	Y UW P AH Z AH R AE V AH JH UW
UPOZORAVALI	Y UW P AH Z AH R AE V AH L IY
UPOZORAVATI	Y UW P AH Z AH R AE V AH T IY
UPOZORENJA	Y UW P AH Z AH R EH N JH AH
UPOZORENJE	Y UW P AA Z AH R AH N JH
UPOZORENJEM	Y UW P AH Z AH R EH N JH AH M
UPOZORIO	Y UW P AH Z AO R IY OW
UPRAVA	AH P R AH V AH
UPRAVE	AH P R EY V
UPRAVLJAJU^I	AH P R AE V L JH AH JH UW AY
UPRAVO	AH P R AH V OW
UPRAVOM	AH P R AH V AH M
UPRAVU	AH P R AH V UW
UPUTILO	Y UW P Y UW T AH L OW
UPUTIO	Y UW P Y UW T IY OW
UPUTNICOM	Y UW P AH T N AH K AH M
UPUTNICU	Y UW P AH T N AH K UW
UPU^ENA	Y UW P UW AH N AA
UPU^UJU	Y UW P UW Y UW JH UW
UPU^UJU^I	Y UW P UW Y UW JH UW AY
URAVNOTE`ENE	Y UH R AH V N OW T IH N
UREDA	Y UH R AH D AH
UREDILA	Y AH R EH D AH L AH
UREDIMA	Y AH R EH D AH M AH
UREDNICA	Y AH R EH D N AH K AH
UREDNIK	Y AH R EH D N AH K
UREDNIKA	Y AH R EH D N AH K AH
UREDU	Y UH R AH D UW
URU{AVANJU	Y UH R UW AH V AE N JH UW
URU~IO	Y UH R UW
USKORO	AH S AH R OW
USKRATITI	AH S R AE T AH T IY
USLUGA	AH Z L UW G AH
USLUGE	AH Z L UW JH
USLUGU	AH Z L UW G Y UW
USMJERAVA	AH Z M JH EH R AH V AH
USMJERENI	AH Z M JH EH R AH N IY
USMJERENIM	AH Z M JH EH R AH N AH M
USMJERENJA	AH Z M JH AH R EH N JH AH
USPIO	AH S IY OW
USPJEH	AH S JH
USPJEHE	AH S JH AH HH
USPJE{NI	AH S JH N IY
USPORENOGA	AH S AH R EH N AH G AH
USPOSTAVE	AH S AH S T EY V
USPOSTAVI	AH S AA S T AH V IY
USPOSTAVITI	AH S AH S T AE V AH T IY
USPOSTAVLJEN	AH S AA S T AE V L JH AH N
USPOSTAVU	AH S AA S T AH V UW
USPROTIVIO	AH S R AH T IH V IY OW
USTALIO	AH S T EY L IY OW
USTANOVA	AH S T AE N AH V AH
USTANOVI	AH S T AE N AH V IY
USTAVNE	AH S T AH V N
USTAVNI	AH S T AE V N IY
USTAVNIH	AH S T AE V N IY
USTAVNOME	AH S T AH V N OW M
USTAVNOSTI	AH S T AH V N AA S T IY
USTAVOM	AH S T AH V AH M
USTROJU	AH S T R AH JH UW
USTUPKE	AH S T AH P
USTVRDIO	AH S T V R D IY OW
UTAKMICE	Y UW T AE K M AH S
UTJECAJ	AH T JH AH K AH JH
UTJECAJAN	AH T JH EH K AH JH AH N
UTJECAJEM	AH T JH EH K AH JH AH M
UTJECALI	AH T JH EH K AH L IY
UTJECATI	AH T JH EH K AH T IY
UTJELOVILO	AH T JH AH L AA V AH L OW
UTORAK	Y UW T AH R AH K
UTORKA	Y UW T AO R K AH
UTRCI	AH T R S IY
UTRKU	AH T R K UW
UTVRDILA	AH T V R D AH L AH
UTVR}ENA	AH T V R AH N AA
UTVR}ENIM	AH T V R AH N IH M
UTVR}ENO	AH T V R AH N OW
UTVR}IVANJA	AH T V R AH V AE N JH AH
UTVR}UJE	AH T V R Y UW JH IY
UTVR}UJU	AH T V R Y UW JH UW
UVA`AVANJE	Y UW V AH AE V AH N JH
UVEDENA	Y UW V EH D AH N AH
UVID	Y UW V AH D
UVIJEK	Y UW V AH JH AH K
UVJERIO	AH V IY R IY OW
UVJETA	AH V AH T AH
UVJETE	AH V IY T
UVJETI	AH V AH T IY
UVJE`BANOG	AH V B AE N AH G
UVJE`BAVAJU	AH V B AE V AH JH UW
UVOZ	Y UW V AH Z
UVOZA	Y UW V AH Z AH
UVRIJEDIO	AH V R AH JH IY D IY OW
UZ	AH Z
UZBEKISTAN	UW Z B EH K IH S T AE N
UZBEKISTANU	AH Z AH K IH S T AH N UW
UZRE~ICA	Y UW Z AH R
UZROK	AH Z R AH K
UZROKOVALO	AH Z R AH K AA V AH L OW
UZROKOVANE	AH Z R AA K AH V EY N
UZROKOVANIH	AH Z R AH K AA V AH N IY
UZROKOVANIM	AH Z R AH K AA V AH N AH M
UZVANIKA	AH Z AE N AH K AH
U^I	UW AY
U{LA	UW L AA
U~ENICI	UW
U~ENIK	UW
U~INI	UW
U~INIMO	UW
U~INIO	UW
U~INITI	UW
U~INKOM	UW
U~KU	UW
U~VRSTILA	UW
U~VRSTIO	UW
U~VR{^IVANJE	UW
V	V IY
VAL	V AE L
VALA	V AA L AH
VALOVE	V AH L OW V
VALOVI	V AE L AH V IY
VALOVIMA	V AH L AA V AH M AH
VALOVITI	V AH L AA V AH T IY
VALOVITO	V AH L AA V AH T OW
VALU	V AE L Y UW
VAM	V AE M
VAN	V AE N
VANGOGA	V AE N G AH G AH
VANGOGOM	V AE N G AH G AH M
VANJSKIH	V AE N JH S K IY
VANJSKU	V AE N JH S K UW
VARIJANTA	V AE R AH JH AE N T AH
VATROGASACA	V AE T R AH G AE S AH K AH
VATROMET	V AE T R AH M AH T
VATROMETA	V AE T R AA M AH T AH
VATROMETI	V AE T R AA M AH T IY
VA`AN	V AA AE N
VA`NOST	V AA N AA S T
VA{INGTON	V AA IH N G T AA N
VA{INGTONA	V AA IH N G T AA N AH
VA{INGTONU	V AA IH N G T AA N UW
VEB	V EH B
VEDRANA	V EH D R AH N AH
VEDRO	V EH D R OW
VEHAR	V EH AH R
VELEBITSKOM	V EH L AH B IH T S AH M
VELEPOSLANIK	V EH L AH P AA Z L AH N AH K
VELEPOSLANIKA	V EH L AH P AH Z L AE N AH K AH
VELEPOSLANSTVA	V EH L AH P AH Z L AE N S T V AH
VELESAJMU	V EH L AH S AE JH M UW
VELIK	V EH L AH K
VELIKA	V EH L IH K AH
VELIKE	V L AY K
VELIKI	V EH L AH K IY
VELIKOG	V EH L AH K AH G
VELIKOGODI{NJEG	V EH L AH K AA G AH D IY N JH EH G
VELIKU	V EH L AH K UW
VELIMIR	V EH L AH M AH R
VELIMIRA	V AH L IH M AH R AH
VELI~ANSTVEN	V EH L IY
VELJA~I	V EH L JH AH
VENECIJANSKOM	V EH N AH S AH JH AE N S AH M
VENECIJI	V AH N EH S AH JH IY
VENEZUELSKI	V EH N AH Z UW EH L S IY
VENEZUELU	V EH N AH Z UW AH L UW
VENTILACIJU	V EH N T AH L AE S AH JH UW
VERA	V EH R AH
VERMONTA	V AH R M AA N T AH
VESNA	V EH S N AH
VEST	V EH S T
VEZAMA	V EH Z AH M AH
VEZE	V IY Z
VEZI	V EH Z IY
VE^	V IY
VE^A	V IY AH
VE^E	V IY
VE^EM	V IY EH M
VE^I	V IY AY
VE^IH	V IY IY
VE^INA	V IY AH N AA
VE^INOM	V IY AH N AA M
VE^INU	V IY AH N UW
VE`ICU	V IY IH K UW
VE~ERA{NJE	V IY
VE~ERI	V IY
VIDEO	V IH D IY OW
VIDI^	V IH D IY
VIDLJIVOST	V IH D L JH AH V AH S T
VIDUKA	V IH D Y UW K AH
VIJEKO	V IH JH AH K OW
VIJEST	V AY JH AH S T
VIJESTI	V AH JH EH S T IY
VIJESTIMA	V AH JH EH S T AH M AH
VIJE^A	V AY JH AH
VIJE^E	V AY JH
VIJE^IMA	V AY JH AH M AA
VIJE^U	V AY JH UW
VIKENDA	V AH K EH N D AH
VIKTOR	V IH K T ER
VIKTORA	V IH K T AH R AH
VILJAM	V IH L JH AH M
VILJAMA	V IH L JH AH M AH
VILU	V IH L UW
VIROVITI~KO	V AH R AA V AH T IY
VIRUS	V AY R AH S
VISINI	V IH S AH N IY
VISINU	V IH S AH N UW
VISOKE	V AH S OW K
VISOKI	V IH S AH K IY
VISOKIH	V IH S AH K IY
VISOKIM	V IH S AH K AH M
VISOKO	V IH S AH K OW
VISOKOM	V IH S AH K AH M
VI{A	V IY AH
VI{AK	V IY AE K
VI{E	V IY
VI{EGODI{NJEM	V IY EH G AH D IY N JH EH M
VI{EM	V IY EH M
VI{ESTRANOJ	V IY EH S T R AH N AH JH
VI{KA	V IY K AA
VJEKOSLAVA	V JH AH K AA Z L AH V AH
VJERNICIMA	V JH AH R N IH S AH M AH
VJERNIKA	V JH AH R N AH K AH
VJERODOSTOJNOM	V JH EH R AH D AH S T AA JH N AH M
VJEROISPOVIJESTI	V JH AH R OY S P AH V AH JH EH S T IY
VJEROJATNO	V JH EH R AH JH AE T N OW
VJERSKIH	V JH AH R S IY
VJERSKU	V JH AH R S UW
VJERUJE	V JH AH R UW JH
VJERUJEM	V JH AH R UW JH AH M
VJERUJEMO	V JH AH R UW JH AH M OW
VJETAR	V JH IY T AH R
VJETRA	V JH EH T R AH
VJETROM	V JH EH T R AH M
VLADA	V L AE D AH
VLADAVINE	V L AE D AH V AY N
VLADE	V L EY D
VLADI	V L AE D IY
VLADIMIR	V L AE D AH M IH R
VLADIMIROM	V L AH D IH M AH R AH M
VLADIN	V L AE D AH N
VLADINA	V L AE D AH N AH
VLADINO	V L AE D AH N OW
VLADO	V L AE D OW
VLADU	V L AE D UW
VLAHA	V L AE HH AH
VLAK	V L AE K
VLAKOM	V L AE K AH M
VLAKOVA	V L AE K AH V AH
VLASNICIMA	V L AE Z N IH S AH M AH
VLASNIKA	V L AE Z N AH K AH
VLAST	V L AE S T
VLASTI	V L AE S T IY
VLASTIMA	V L AE S T AH M AH
VLA`NI	V L AA N IY
VODE	V OW D
VODE^IH	V OW D IY
VODI	V OW D IY
VODITELJ	V AA D AH T AH L JH
VODITELJA	V AA D AH T EH L JH AH
VODITI	V AA D AH T IY
VODOSTAJU	V AH D AA S T AH JH UW
VODU	V OW D UW
VOJISLAVA	V AH JH IH Z L AH V AH
VOJNE	V AA JH N
VOJNI	V AA JH N IY
VOJNICI	V AA JH N AH S IY
VOJNICIMA	V AA JH N IH S AH M AH
VOJNIK	V AA JH N AH K
VOJNIKA	V AA JH N AH K AH
VOJNIKE	V AA JH N AY K
VOJNOG	V AA JH N AH G
VOJNOJ	V AA JH N AH JH
VOJSKA	V AA JH S K AH
VOJSKE	V AA JH S K
VOLGANG	V OW L G AH NG
VOLJA	V OW L JH AH
VOZA~	V OW Z AH
VOZA~E	V OW Z AH
VOZA~I	V OW Z AH
VOZA~IMA	V OW Z AH
VOZA~KE	V OW Z AH
VOZI	V OW Z IY
VOZILA	V AA Z AH L AH
VOZILIMA	V AH Z IH L AH M AH
VO`NJA	V OW N JH AA
VO`NJE	V OW N JH IY
VO`NJU	V OW N JH UW
VO}A	V OW AH
VO}U	V OW UW
VRATA	V R AE T AH
VRATIMA	V R AE T AH M AH
VRATITI	V R AE T AH T IY
VRBOVSKO	V R B AA V S K OW
VRBOVSKOG	V R B AA V S K AH G
VREMENA	V R EH M AH N AH
VREMENOM	V R EH M AH N AH M
VREMENSKA	V R AH M EH N S AH
VREMENSKE	V R EH M AH N S
VREMENU	V R EH M AH N UW
VRHOVNI	V R AA V N IY
VRHOVNIKA	V R AA V N AH K AH
VRHOVNIKOM	V R AA V N AH K AH M
VRHOVNOG	V R AA V N AH G
VRHOVNOGA	V R AA V N AH G AH
VRHU	V R UW
VRIJEDAN	V R IH JH AH D AH N
VRIJEDI	V R IH JH AH D IY
VRIJEDIT	V R IH JH AH D AH T
VRIJEDNOST	V R AH JH EH D N AH S T
VRIJEDNOSTI	V R IH JH AH D N AA S T IY
VRIJEME	V R AH JH IY M
VRLO	V R L OW
VRPCAMA	V R P AE M AH
VRSNOG	V R S N AA G
VRTOGLAVA	V R T AA G L AH V AH
VRU^E	V R UW
VUKA	V Y UW K AH
VUKMAN	V AH K M AH N
VUKOVAR	V UW K AH V AA R
VUKOVI^	V Y UW K AH V IY
VUKOVOJ	V Y UW K AH V AH JH
VULKAN	V AH L K AH N
VULKANSKE	V AH L K AH N S
VU~U	V UW
ZA	Z AA
ZABAVA	Z AE B AH V AH
ZABAVLJALI	Z AH B AE V L JH AH L IY
ZABAVNIH	Z AH B AE V N IY
ZABILJE`EN	Z AE B AH L JH EH N
ZABILJE`ENIH	Z AE B AH L JH AH N IY
ZABILJE`ILI	Z AE B AH L JH IH L IY
ZABIO	Z EY B IY OW
ZABORAVITI	Z AE B AH R AE V AH T IY
ZABRANA	Z AE B R AH N AH
ZABRANAMA	Z AE B R AE N AH M AH
ZABRANILA	Z AE B R AE N AH L AH
ZABRANJENO	Z AE B R AE N JH AH N OW
ZABRINUTI	Z AE B R AH N Y UW T IY
ZADANOSTI	Z AE D AH N AA S T IY
ZADAR	Z EY D AA R
ZADAR(2)	Z IH D AA R
ZADA^A	Z AE D AH AH
ZADA^AMA	Z AE D AH AE M AH
ZADA^OM	Z AE D AH AA M
ZADNJEM	Z AE D N JH AH M
ZADNJOJ	Z AE D N JH AH JH
ZADOVOLJAN	Z AE D AH V OW L JH AH N
ZADOVOLJNI	Z AE D AH V OW L JH N IY
ZADRA	Z AE D R AH
ZADR`AO	Z AE D R EY OW
ZADR`AVA	Z AE D R AE V AH
ZADR`AVANJE	Z AE D R AE V AH N JH
ZADR`E	Z AE D R
ZAGORSKOM	Z AH G AO R S AH M
ZAGREB	Z AA G R EH B
ZAGREBA	Z AE G R AH B AH
ZAGREBA~KA	Z AE G R AH B AH
ZAGREBA~KE	Z AE G R AH B AH
ZAGREBA~KI	Z AE G R AH B AH
ZAGREBA~KOGA	Z AE G R AH B AH
ZAGREBA~KOJ	Z AE G R AH B AH
ZAGREBA~KOM	Z AE G R AH B AH
ZAGREBA~KOME	Z AE G R AH B AH
ZAGREBOM	Z AE G R AH B AH M
ZAGREBU	Z AE G R AH B UW
ZAHLA}ENJE	Z AE L AH IH N JH IY
ZAHTIJEVAJU	Z AE T AH JH EH V AH JH UW
ZAHTJEV	Z AE T JH AH V
ZAHTJEVA	Z AE T JH AH V AH
ZAHTJEVIMA	Z AE T JH EH V AH M AH
ZAHTJEVU	Z AE T JH AH V UW
ZAHVALJUJE	Z AE V AH L JH UW JH
ZAHVATA	Z AE V AH T AH
ZAHVATI	Z AE V AH T IY
ZAHVATILA	Z AH V AE T AH L AH
ZAHVATITI	Z AH V AE T AH T IY
ZAJAM~ENA	Z AE JH AH M
ZAJEDNICA	Z AH JH EH D N AH K AH
ZAJEDNICE	Z AH JH EH D N AH S
ZAJEDNICI	Z AH JH EH D N AH S IY
ZAJEDNI{TVO	Z AH JH EH D N IY T V OW
ZAJEDNI~KI	Z AH JH EH D N IY
ZAJEDNI~KOG	Z AH JH EH D N IY
ZAJEDNI~KU	Z AH JH EH D N IY
ZAJEDNO	Z AH JH EH D N OW
ZAKLETVOM	Z AE K L EH T V AH M
ZAKLJU~AKA	Z AE K L JH UW
ZAKLJU~ILI	Z AE K L JH UW
ZAKLJU~IO	Z AE K L JH UW
ZAKLJU~KU	Z AE K L JH UW
ZAKLJU~UJE	Z AE K L JH UW
ZAKON	Z AE K AH N
ZAKONA	Z AE K AH N AH
ZAKONIKA	Z AH K AA N AH K AH
ZAKONITOSTI	Z AE K AH N AH T AA S T IY
ZAKONOM	Z AE K AH N AH M
ZAKONSKI	Z AH K AA N S IY
ZAKUP	Z AE K AH P
ZALE}U	Z EY L UW
ZAMIJENILI	Z AE M AH JH EH N AH L IY
ZAMIJENITI	Z AE M AH JH EH N AH T IY
ZAMISAO	Z AH M IH S EY OW
ZAMJENICU	Z AE M JH EH N AH K UW
ZAMJENIK	Z AE M JH AH N AH K
ZAMJENIKA	Z AE M JH EH N AH K AH
ZAMJENJUJE	Z AE M JH AH N JH UW JH
ZAMRZAVANJA	Z AE M R Z AH V AE N JH AH
ZANIMLJIVIH	Z AH N IH M L JH AH V IY
ZANIMLJIVO	Z AH N IH M L JH AH V OW
ZANIMLJIVOST	Z AH N IH M L JH AH V AH S T
ZAOBI{LI	Z EY AH B IY L IY
ZAPAD	Z AE P AH D
ZAPADA	Z AE P AH D AH
ZAPADNE	Z AE P AH D N
ZAPADNI	Z AH P AE D N IY
ZAPADNIM	Z AH P AE D N AH M
ZAPADNJAK	Z AH P AE D N JH AH K
ZAPADNO	Z AH P AE D N OW
ZAPADNOEUROPSKI	Z AH P AH D N OW AH AH R AA P S IY
ZAPADNOJ	Z AH P AE D N AH JH
ZAPADNOM	Z AH P AE D N AH M
ZAPADNU	Z AH P AE D N UW
ZAPADU	Z AE P AH D UW
ZAPALIO	Z AH P EY L IY OW
ZAPALJENA	Z AH P AE L JH AH N AH
ZAPALJENO	Z AH P AE L JH AH N OW
ZAPLIJENILA	Z AE P L AH JH EH N AH L AH
ZAPOSLENI	Z AH P AA Z L AH N IY
ZAPOSLENIH	Z AH P AA Z L AH N IY
ZAPOSLENIKA	Z AE P AH Z L EH N AH K AH
ZAPOVIJED	Z AE P AH V AY JH D
ZAPOVJEDNIK	Z AE P AH V EH D N AH K
ZAPOVJEDNIKA	Z AE P AH V EH D N AH K AH
ZAPOVJEDNI{TVO	Z AE P AH V EH D N IY T V OW
ZAPOVJEDNOJ	Z AE P AH V EH D N AH JH
ZAPUHAT	Z AE P AH HH AH T
ZAPUHATI	Z AH P AH HH AH T IY
ZARAZE	Z AH R EY Z
ZASAD	Z AE S AH D
ZASJEDANJU	Z AE Z AH D AE N JH UW
ZASLIJEPILI	Z AE Z L AH JH EH P AH L IY
ZASLUGE	Z AE Z L UW JH
ZASTAVE	Z AE S T EY V
ZASTOJA	Z AE S T AH JH AH
ZASTUPATI	Z AE S T Y UW P AH T IY
ZASTUPNIK	Z AE S T AH P N AH K
ZASTUPNIKA	Z AE S T AH P N AH K AH
ZASTUPNIKE	Z AE S T AH P N AY K
ZATEKLA	Z AH T EH K L AH
ZATIM	Z AE T AH M
ZATO	Z AE T OW
ZATO~EN	Z AE T OW
ZATO~ENIKA	Z AE T OW
ZATRA`ILA	Z AE T R AH IH L AH
ZATRA`IO	Z AE T R AH AY OW
ZATRA`ITI	Z AE T R AH IH T IY
ZATVOR	Z AE T V AH R
ZATVORA	Z AE T V AH R AH
ZATVORENA	Z AE T V AO R AH N AH
ZATVORENE	Z AE T V AH R IY N
ZATVORENIH	Z AE T V AO R AH N IY
ZATVORENIM	Z AE T V AO R AH N AH M
ZATVORILE	Z AE T V AH R AH L
ZATVORILO	Z AE T V AO R AH L OW
ZATVORSKE	Z AE T V AH R S
ZATVORSKU	Z AE T V AO R S UW
ZAUSTAVE	Z AO S T EY V
ZAUSTAVI	Z AO S T AH V IY
ZAUSTAVILI	Z AO S T AE V AH L IY
ZAUSTAVIO	Z AO S T EY V IY OW
ZAUSTAVLJENI	Z AO S T AE V L JH AH N IY
ZAUVIJEK	Z AO V AH JH AH K
ZAUZELI	Z AO Z AH L IY
ZAUZIMA	Z AO Z AH M AH
ZAUZIMAO	Z AH Z IH M EY OW
ZAVODA	Z AE V AH D AH
ZAVR{EN	Z AE V R EH N
ZAVR{ENE	Z AE V R IH N
ZAVR{ETAK	Z AE V R EH T AH K
ZAVR{ETKA	Z AE V R EH T AH
ZAVR{ILI	Z AE V R IH L IY
ZAVR{IO	Z AE V R AY OW
ZAVR{NE	Z AE V R N IY
ZA{TITARSKE	Z AA T IH T AH R S
ZA{TITARSTVA	Z AA T AH T AA R S T V AH
ZA{TITE	Z AA T AY T
ZA{TITILI	Z AA T IH T AH L IY
ZA{TITITI	Z AA T IH T AH T IY
ZA{TITNIKA	Z AA T IH T N AH K AH
ZA{TITU	Z AA T IH T UW
ZA{TO	Z AA T UW
ZBIO	Z B AY OW
ZBOG	Z B AA G
ZDENKA	Z D EH NG K AH
ZDRAVA	Z D R AE V AH
ZDRAVLJA	Z D R AE V L JH AH
ZDRAVLJU	Z D R AE V L JH UW
ZDRAVSTVA	Z D R AE V S T V AH
ZDRAVSTVENE	Z D R AE V S T V IY N
ZDRAVSTVENI	Z D R AE V S T V AH N IY
ZDRAVSTVENO	Z D R AE V S T V AH N OW
ZDRAVSTVENOM	Z D R AE V S T V AH N AH M
ZDRAVSTVO	Z D R AE V S T V OW
ZDRAVSTVU	Z D R AE V S T V UW
ZEMALJA	Z AH M AE L JH AH
ZEMLJA	Z EH M L JH AH
ZEMLJAMA	Z EH M L JH AH M AH
ZEMLJE	Z EH M L JH
ZEMLJI	Z EH M L JH IY
ZEMLJOM	Z EH M L JH AH M
ZEMLJU	Z EH M L JH UW
ZGRADA	Z G R AE D AH
ZGRADAMA	Z G R AE D AH M AH
ZGRADE	Z G R EY D
ZGRADOM	Z G R AE
ZGRADU	Z G R AE D UW
ZID	Z IH D
ZIDA	Z IH D AH
ZIMSKE	Z IH M S
ZIMSKI	Z IH M S IY
ZIMSKIH	Z IH M S IY
ZIMSKU	Z IH M S UW
ZLA	Z L AA
ZLATAN	Z L EY T AH N
ZLATKO	Z L AE T OW
ZLATNI	Z L AE T N IY
ZLATNIH	Z L AE T N IY
ZLATNU	Z L AE T N UW
ZLOPORABE	Z L AA P AH R EY B
ZLOSTAVLJANJE	Z L AA S T AE V L JH AH N JH
ZLOUPORABU	Z L UW P AO R AH B UW
ZLO~INA	Z L OW
ZLO~INE	Z L OW
ZLO~INIMA	Z L OW
ZNA	Z N AA
ZNAK	Z N AE K
ZNAKU	Z N AE K UW
ZNALO	Z N AE L OW
ZNAM	Z N AE M
ZNANOST	Z N AE N AH S T
ZNANSTVENI	Z N AE N S T V AH N IY
ZNANSTVENIKA	Z N AE N S T V EH N AH K AH
ZNANSTVENOG	Z N AE N S T V AH N AH G
ZNAT	Z N AE T
ZNATNO	Z N AE T N OW
ZNATNU	Z N AE T N UW
ZNA~ENJE	Z N AA
ZNA~I	Z N AA
ZORANA	Z AO R AE N AH
ZRAK	Z R AE K
ZRAKA	Z R AE K AH
ZRAKOPLOV	Z R AH K AA P L AH V
ZRAKOPLOVA	Z R AH K AA P L AH V AH
ZRAKOPLOVOM	Z R AH K AA P L AH V AH M
ZRAKOPLOVSTVA	Z R AE K AH P L AA V S T V AH
ZRA~ENJEM	Z R AA
ZRA~NE	Z R AA
ZRA~NIH	Z R AA
ZVONA	Z V AA N AH
ZVONIMIR	Z V AA N AH M AH R
^E	
^EMO	AH M OW
`AK	AE K
`ALITI	AE L AH T IY
`ALOST	AH L AO S T
`ALOSTI	AH L AA S T IY
`ELI	EH L IY
`ELIO	IY L IY OW
`ELJELI	EH L JH AH L IY
`ELJEZNICA	EH L JH EH Z N AH K AH
`ELJEZNICE	EH L JH EH Z N AH S
`ELJEZNICI	EH L JH EH Z N AH S IY
`ELJEZNI~KIH	EH L JH EH Z N IY
`ELJEZNI~KOJ	EH L JH EH Z N IY
`ELJKO	EH L JH K OW
`ENAMA	AH N AE M AH
`ENSKU	IH N S UW
`ESTOKIH	EH S T AH K IY
`ICOM	IH K AH M
`IDOVA	IH D AH V AH
`IDOVSKOG	AH D AA V S K AH G
`IRO	IH R OW
`IV	IH V
`IVA	IH V AH
`IVE	AY V
`IVJETI	IH V AH T IY
`IVKOVI^A	IH V K AH V IY AH
`IVOT	IH V AH T
`IVOTNI	AH V AA T N IY
`IVOTNO	AH V AA T N OW
`IVOTNOJ	AH V AA T N AH JH
`OAKIN	OW K IH N
`RTAVA	R T AE V AH
`RTVAMA	R T V AE M AH
`RTVE	R T V
`UPAN	Y UW P AH N
`UPANA	Y UW P AH N AH
`UPANIJA	Y UW P AE N AH JH AH
`UPANIJE	Y UW P AH N AY JH
`UPANIJI	Y UW P AE N AH JH IY
`UPANIJSKIM	Y UW P AH N IH JH S K AH M
`UPANIJSKOG	Y UW P AH N IH JH S K AH G
`UPANIJSKOGA	Y UW P AH N IH JH S K AH G AH
`UPANIJU	Y UW P AE N AH JH UW
`URNE	AH R N
`URNIJIM	AH R N AH JH AH M
`UTU	Y UW T UW
`U`UL	UW AH L
`U`ULA	UW Y UW L AH
`U`ULOM	UW Y UW L AH M
{ALJU	AE L JH UW
{AMAC	AE M AH K
{ANSE	AE N S
{ARIPOV	AE R AH P AH V
{ARIPOVA	AH R IH P OW V AH
{ARON	AE R AH N
{ARONA	AE R AH N AH
{ARONOVA	AH R AA N AH V AH
{A{INOVCU	AH AH N AA V K UW
{EF	EH F
{EFOVA	EH F AH V AH
{EKS	EH K S
{EKSOM	EH K S AH M
{ELOM	EH L AH M
{ENTIJA	IH N T IH JH AH
{EPAROVI^	AH P AE R AH V IY
{ESNAEST	EH Z N EY AH S T
{ESNAESTERO	EH Z N IY S T AH R OW
{ESNAESTOGODI{NJI	EH Z N IY S T AA G AH D IY N JH IY
{EST	EH S T
{ESTE	EH S T
{ESTO	EH S T OW
{ESTOGA	EH S T AH G AH
{ESTOMJESE~NU	EH S T AH M JH IY Z
{ESTORICA	EH S T AO R AH K AH
{ETAO	EH T EY OW
{ETKA	EH T AH
{ETNJE	EH T N JH
{EVKU	EH V K UW
{EZDESET	EH Z D AH S AH T
{EZDESETAK	EH Z D EH S AH T AH K
{EZDESETDVIJE	EH Z D EH S AH T D V AY JH
{IBENSKO	AH B EH N S OW
{INCEK	IH N S EH K
{IRAK	IH R AH K
{IREG	IH R AH G
{IREM	IH R AH M
{IRI	IH R IY
{IRILA	IH R AH L AH
{IROKO	IH R AH K OW
{ISL	IH Z L
{KOLARINA	K AH L AE R AH N AH
{KOLARINE	K AA L AH R AY N
{KOLOVANJE	K AA L AH V AH N JH
{KOLSKE	K OW L S
{KOLSKIH	K OW L S IY
{KOLSKU	K OW L S UW
{KOLSTVO	K OW L S T V OW
{KRGULJA	K R G AH L JH AH
{OLTI	OW L T IY
{PANJOLSKI	P AE N JH OW L S IY
{PANJOLSKIM	P AE N JH OW L S AH M
{PIGEL	P IH JH AH L
{PIGLA	P IH G L AH
{REDER	R EH D ER
{RI	R IY
{RILANKI	R AH L AE NG K IY
{TEDI{AMA	T EH D IY AE M AH
{TEDNJE	T EH D N JH
{TETA	T EH T AH
{TETU	T EH T UW
{TO	T UW
{TRAJK	T R AE JH K
{TRAJKAJU	T R AE JH K AH JH UW
{TRAJKOVI	T R AE JH K AH V IY
{UICA	UW K AH
{UME	Y UW M IY
{UMI	Y UW M IY
{UTNJA	AH T N JH AH
{UTNJE	AH T N JH
{VEDSKA	V EH D S K AH
{VEDSKI	V EH D S K IY
{VICARSKOGA	V AH K AA R S AH G AH
{VICARSKOJ	V AH K AA R S AH JH
}ON}EVI^	AO N EH V IY
}OR}O	AO R OW
}UKANOVI^	Y UW K AE N AH V IY
~AK	AE K
~ARLS	AA R L Z
~ASNICI	AE Z N AH S IY
~ASNIK	AE Z N AH K
~ASNIKA	AE Z N AH K AH
~AST	AE S T
~A{U	AH UW
~EGA	EH G AH
~EKA	EH K AH
~EKALO	EH K AH L OW
~EKANJA	AH K AE N JH AH
~EKANJE	EH K AH N JH
~EKATI	EH K AH T IY
~ELNICA	EH L N AH K AH
~ELNICI	EH L N AH S IY
~ELNIKA	EH L N AH K AH
~EMU	AH M UW
~EN{UIBIJAN	EH N UW B AH JH AH N
~EPINA	EH P AH N AH
~ESTITALI	EH S T IH T AH L IY
~ESTITAO	EH S T IH T EY OW
~ESTITKI	EH S T IH T IY
~ESTITKU	EH S T IH T UW
~ESTO	EH S T OW
~ETIRI	EH T AH R IY
~ETIRIJU	AH T IH R AH JH UW
~ETIRIMA	AH T IH R AH M AH
~ETIRISTO	EH T AH R IH S T OW
~ETRDESET	EH T R D AH S AH T
~ETRDESETOGODI{NJI	EH T R D AH S AH T AA G AH D IY N JH IY
~ETRNAEST	EH T R N EY AH S T
~ETRNAESTOGA	EH T R N IY S T AH G AH
~ETVERA	EH T V AH R AH
~ETVEROGODI{NJE	EH T V AH R AA G AH D IY N JH IY
~ETVEROGODI{NJI	EH T V AH R AA G AH D IY N JH IY
~ETVORICA	EH T V AO R AH K AH
~ETVORICE	EH T V AH R AH S
~ETVORNIH	EH T V AO R N IY
~ETVRTAK	EH T V R T AH K
~ETVRTE	EH T V R T
~ETVRTIMA	EH T V R T AH M AH
~ETVRTOG	EH T V R T AH G
~IAO	AY EY OW
~IAOA	AY EY OW AH
~IAU	AY AH
~IJA	IH JH AH
~IJE	AY JH
~IJEM	IH JH AH M
~ILE	AY L
~ILEANSKI	AH L IY N S IY
~ILEANSKOG	AH L IY N S AH G
~ILEOM	IH L IY AH M
~IM	IH M
~IME	IH M
~INI	AH N IY
~INJENICA	IH N JH EH N AH K AH
~INJENICAMA	IH N JH AH N IH K AH M AH
~INJENICE	IH N JH IY N AH S
~INJENICU	IH N JH EH N AH K UW
~ISTI	IH S T IY
~I{^ENJA	AY IH N JH AA
~LAN	L AE N
~LANAK	L AE N AH K
~LANICA	L AE N AH K AH
~LANICAMA	L AH N IH K AH M AH
~LANICE	L AE N AH S
~LANICI	L AE N AH S IY
~LANOVA	L AE N AH V AH
~LANOVIMA	L AH N AA V AH M AH
~LANSTVO	L AE N S T V OW
~LANSTVU	L AE N S T V UW
~OPOR	OW P AH R
~OPU	AA P UW
~OVI^A	AA V IY AH
~OVJEKA	AA V AH K AH
~OVJE~ANSTVA	AA V
~VORA	V AO R AH
~VOROVA	V AO R AH V AH
